a	a
aba	a b_< a
abafunda	a b_< a f u n d a
abafundi	a b_< a f u n d i
abagcina	a b_< a !_bg i n a
abagcqina	a b_< a !_bg !_b i n a
abagqina	a b_< a !_bg i n a
abahlakaniph	a b_< a K a k a n i p_h
abahlakanipha	a b_< a K a k a n i p_h a
abak	a b_< a k
abakhe	a b_< a k_h E
abakuthole	a b_< a k u t_h O l E
abakwazi	a b_< a k w a z i
abalalele	a b_< a l a l E l E
abalele	a b_< a l E l E
abambe	a b_< a m b E
abambeswe	a b_< a m b E s w E
abancani	a b_< a n |_b a n i
abang	a b_< a N g
abanga	a b_< a N g a
abanganaba	a b_< a N g a n a b_< a
abanganabo	a b_< a N g a n a b_< O
abanqa	a b_< a n !_b a
abanqan	a b_< a n !_b a n
abant	a b_< a n t_>
abantabethu	a b_< a n t_> a b_< E t_h u
abantu	a b_< a n t_> u
abantwa	a b_< a n t_> w a
abantwana	a b_< a n t_> w a n a
abantwanabethu	a b_< a n t_> w a n a b_< E t_h u
abanye	a b_< a J E
abasa	a b_< a s a
abasabonaka	a b_< a s a b_< O n a k a
abasabonakali	a b_< a s a b_< O n a k a l i
abasi	a b_< a s i
abawe	a b_< a w E
abayenzi	a b_< a j E n z i
abayibone	a b_< a j i b_< O n E
abazali	a b_< a z a l i
abazazi	a b_< a z a z i
abazembatha	a b_< a z E m b a t_h a
abazembathako	a b_< a z E m b a t_h a k O
abazi	a b_< a z i
abazikghona	a b_< a z i kx O n a
abazikghonako	a b_< a z i kx O n a k O
abazo	a b_< a z O
abazokuhlola	a b_< a z O k u K O l a
abe	a b_< E
abek	a b_< E k
abekanayo	a b_< E k a n a j O
abelethelwa	a b_< E l E t_h E l w a
abentwana	a b_< E n t_> w a n a
abesanabo	a b_< E s a n a b_< O
abeze	a b_< E z E
abezembathako	a b_< E z E m b a t_h a k O
abhoduluka	a b O d u l u k a
abile	a b_< i l E
abize	a b_< i z E
abo	a b_< O
abodladla	a b_< O K_b a K_b a
abogogo	a b_< O g O g O
abokholiwe	a b_< O k_h O l i w E
abomavela	a b_< O m a v E l a
abonamtshweni	a b_< O n a m ts_h w E n i
abone	a b_< O n E
abophe	a b_< O p_h E
abophele	a b_< O p_h E l E
abosodlhamedzwana	a b_< O s O K_b a m E dz w a n a
abosomodere	a b_< O s O m O d E r E
abososayensi	a b_< O s O s a j E n s i
abotjhelelwe	a b_< O tS_h E l E l w E
abovu	a b_< O v u
abu	a b_< u
abunan	a b_< u n a n
abunane	a b_< u n a n E
abune	a b_< u n E
aburhicwa	a b_< u x i |_b w a
aburhiqwa	a b_< u x i !_b w a
abuyako	a b_< u j a k O
abuye	a b_< u j E
abuyele	a b_< u j E l E
abuza	a b_< u z a
abuze	a b_< u z E
aditjha	a d i tS_h a
adla	a K_b a
adlange	a K_b a N g E
adlile	a K_b i l E
adosa	a d O s a
aduleka	a d u l E k a
aduleke	a d u l E k E
afikile	a f i k i l E
afise	a f i s E
afri	a f r i
afrik	a f r i k
afrika	a f r i k a
afune	a f u n E
agad	a g a d
agadange	a g a d a N g E
agandelele	a g a n d E l E l E
agcina	a !_bg i n a
agijimisana	a g i d_0Z i m i s a n a
ahl	a K
ahlangane	a K a N g a n E
ahlangene	a K a N g E n E
ahlanze	a K a n z E
ahlezi	a K E z i
ahlomileko	a K O m i l E k O
ahlwa	a K w a
ajamile	a d_0Z a m i l E
aka	a k a
akadlalelwa	a k a K_b a l E l w a
akaguq	a k a g u !_b
akahl	a k a K
akajayeli	a k a d_0Z a j E l i
akakajayelani	a k a k a d_0Z a j E l a n i
akakayiqe	a k a k a j i !_b E
akakayiqedi	a k a k a j i !_b E d i
akakho	a k a k_h O
akam	a k a m
akamazi	a k a m a z i
akanama	a k a n a m a
akanamandlakhe	a k a n a m a n K_b a k_h E
akasajayelani	a k a s a d_0Z a j E l a n i
akasatshwenyi	a k a s a ts_h w E J i
akatelelwe	a k a t_> E l E l w E
akatshwenyi	a k a ts_h w E J i
akawazi	a k a w a z i
akaya	a k a j a
akayaz	a k a j a z
akayazi	a k a j a z i
akazalisi	a k a z a l i s i
akazi	a k a z i
akazizalisi	a k a z i z a l i s i
akekho	a k E k_h O
akghone	a kx O n E
akh	a k_h
akhambe	a k_h a m b E
akhange	a k_h a N g E
akhanyisele	a k_h a J i s E l E
akhanyiselwe	a k_h a J i s E l w E
akhe	a k_h E
akhenge	a k_h E N g E
akhiwe	a k_h i w E
akho	a k_h O
akhombako	a k_h O m b a k O
akhulu	a k_h u l u
akiyo	a k i j O
aku	a k u
akuguqweni	a k u g u !_b w E n i
akukho	a k u k_h O
akumvimbi	a k u m v i m b i
akusa	a k u s a
akusathokozwa	a k u s a t_h O k O z w a
akusatl	a k u s a tK_>
akusiyo	a k u s i j O
akusuye	a k u s u j E
akwethula	a k w E t_h u l a
al	a l
alale	a l a l E
alanga	a l a N g a
aleke	a l E k E
ali	a l i
alibone	a l i b_< O n E
alihlanu	a l i K a n u
alikho	a l i k_h O
alikhomba	a l i k_h O m b a
alindele	a l i n d E l E
alinge	a l i N g E
aliq	a l i !_b
aliqalaqale	a l i !_b a l a !_b a l E
alise	a l i s E
alisumi	a l i s u m i
alit	a l i t_h
alithatha	a l i t_h a t_h a
alitho	a l i t_h O
alithoba	a l i t_h O b_< a
alithobe	a l i t_h O b_< E
alithole	a l i t_h O l E
alitjhumi	a l i tS_h u m i
allemansdrift	a l l E m a n s d r i f t_h
alo	a l O
alok	a l O k
alokhu	a l O k_h u
alotjolwe	a l O tS_h O l w E
am	a m
ama	a m a
amabhontjisi	a m a b O n tS_h i s i
amabili	a m a b_< i l i
amabilli	a m a b_< i l l i
amabizo	a m a b_< i z O
amabutho	a m a b_< u t_h O
amadoda	a m a d O d a
amadoro	a m a d O r O
amadorojana	a m a d O r O a n a
amadro	a m a d r O
amadrobha	a m a d r O b a
amadrojana	a m a d r O a n a
amadzinyani	a m a dz i J a n i
amaf	a m a f
amafutha	a m a f u t_h a
amagama	a m a g a m a
amahl	a m a K
amahlanu	a m a K a n u
amakhasi	a m a k_h a s i
amakhezo	a m a k_h E z O
amakhomba	a m a k_h O m b a
amakhu	a m a k_h u
amakhulu	a m a k_h u l u
amal	a m a l
amalanga	a m a l a N g a
amalangana	a m a l a N g a n a
amalembabo	a m a l E m b a b_< O
amalembe	a m a l E m b E
amalu	a m a l u
amamthathu	a m a m t_h a t_h u
aman	a m a n
amana	a m a n a
amanaba	a m a n a b_< a
amandla	a m a n K_b a
amandlakhe	a m a n K_b a k_h E
amane	a m a n E
amanese	a m a n E s E
amanesi	a m a n E s i
amanz	a m a n z
amanzi	a m a n z i
amaphepha	a m a p_h E p_h a
amapholisa	a m a p_h O l i s a
amaqanda	a m a !_b a n d a
amaqutjana	a m a !_b u tS_> a n a
amarobodo	a m a r O b_< O d O
amasi	a m a s i
amasu	a m a s u
amasumi	a m a s u m i
amat	a m a t_h
amathandathu	a m a t_h a n d a t_h u
amathathu	a m a t_h a t_h u
amatjhila	a m a tS_h i l a
amatjhumi	a m a tS_h u m i
amatjhuni	a m a tS_h u n i
amatorhwana	a m a t_> O x w a n a
amazi	a m a z i
amehlo	a m E K O
amehlwakhe	a m E K w a k_h E
ameni	a m E n i
amhlabe	a m K a b_< E
amhlobo	a m K O b_< O
amkhulis	a m k_h u l i s
amkhulise	a m k_h u l i s E
amkhulisele	a m k_h u l i s E l E
amo	a m O
amrhuwelela	a m x u w E l E l a
amsunduze	a m s u n d u z E
amthole	a m t_h O l E
an	a n
ana	a n a
anamasumi	a n a m a s u m i
and	a n d
aneminyaka	a n E m i J a k a
ang	a N g
anga	a N g a
angabe	a N g a b_< E
angabona	a N g a b_< O n a
angabonwa	a N g a b_< O n w a
angaka	a N g a k a
angakambathi	a N g a k a m b a t_h i
angakatjhad	a N g a k a tS_h a d
angakatjhadi	a N g a k a tS_h a d i
angakatjhat	a N g a k a tS_h a t_h
angake	a N g a k E
angakenzi	a N g a k E n z i
angakhambi	a N g a k_h a m b i
angamazi	a N g a m a z i
angambatha	a N g a m b a t_h a
anganelisa	a N g a n E l i s a
angaphasi	a N g a p_h a s i
angatjhad	a N g a tS_h a d
angatjhadi	a N g a tS_h a d i
angaz	a N g a z
angazanelisa	a N g a z a n E l i s a
angazi	a N g a z i
angazithola	a N g a z i t_h O l a
angazitholela	a N g a z i t_h O l E l a
ange	a N g E
angekhe	a N g E k_h E
angeze	a N g E z E
angikakatjhad	a N g i k a k a tS_h a d
angikathathi	a N g i k a t_h a t_h i
angikatjha	a N g i k a tS_h a
angikatjhad	a N g i k a tS_h a d
angikatjhadi	a N g i k a tS_h a d i
angikatjhadzi	a N g i k a tS_h a dz i
anginikela	a N g i n i k E l a
angithi	a N g i t_h i
ani	a n i
aniyila	a n i j i l a
aniyithatheli	a n i j i t_h a t_h E l i
anjal	a n d_0Z a l
anjalo	a n d_0Z a l O
ankhone	a N k_h O n E
ano	a n O
anqophe	a n !_b O p_h E
anqophene	a n !_b O p_h E n E
anthological	a n t_h O l O g i |_b a l
anu	a n u
anyangeni	a J a N g E n i
anzima	a n z i m a
aphefumula	a p_h E f u m u l a
aphethe	a p_h E t_h E
aphukileko	a p_h u k i l E k O
aphuma	a p_h u m a
aphume	a p_h u m E
apreli	a p_h r E l i
aqedile	a !_b E d i l E
aqedwa	a !_b E d w a
aqo	a !_b O
aqophene	a !_b O p_h E n E
aqotjha	a !_b O tS_h a
arhuwelela	a x u w E l E l a
artytenoid	a r t_h j t_> E n O i d
as	a s
asa	a s a
asab	a s a b_<
asabhambalele	a s a b a m b a l E l E
asajamile	a s a d_0Z a m i l E
asajamileko	a s a d_0Z a m i l E k O
asale	a s a l E
asaphila	a s a p_h i l a
asararekile	a s a r a r E k i l E
aseduze	a s E d u z E
asekhaya	a s E k_h a j a
asi	a s i
asibuza	a s i b_< u z a
asikaris	a s i k a r i s
asikarisi	a s i k a r i s i
asikhombisa	a s i k_h O m b i s a
asikime	a s i k i m E
asikwazi	a s i k w a z i
asikwo	a s i k w O
asise	a s i s E
asithadathu	a s i t_h a d a t_h u
asithanda	a s i t_h a n d a
asithandathu	a s i t_h a n d a t_h u
asitjhide	a s i tS_h i d E
asitjhu	a s i tS_h u
asitutwan	a s i t_> u t_> w a n
asitutwana	a s i t_> u t_> w a n a
asiyekelezeni	a s i j E k E l E z E n i
asize	a s i z E
asternoid	a s t_> E r n O i d
asuma	a s u m a
asuselwa	a s u s E l w a
at	a t_h
ath	a t_h
athathu	a t_h a t_h u
athengisa	a t_h E N g i s a
athi	a t_h i
athobako	a t_h O b_< a k O
athok	a t_h O k
athokoze	a t_h O k O z E
athole	a t_h O l E
athuke	a t_h u k E
ati	a t_> i
atit	a t_> i t_h
atjelwe	a tS_> E l w E
atjhayela	a tS_h a j E l a
atjho	a tS_h O
atjhumi	a tS_h u m i
atli	a tK_> i
ava	a v a
avula	a v u l a
awa	a w a
awakhiphe	a w a k_h i p_h E
awakho	a w a k_h O
awakholwe	a w a k_h O l w E
awakhuphe	a w a k_h u p_h E
awaqeda	a w a !_b E d a
awaqede	a w a !_b E d E
awathu	a w a t_h u
awathumele	a w a t_h u m E l E
awavalile	a w a v a l i l E
awu	a w u
awuhlali	a w u K a l i
awukahluki	a w u k a K u k i
awuqede	a w u !_b E d E
awusadliwa	a w u s a K_b i w a
awuthola	a w u t_h O l a
awuthumele	a w u t_h u m E l E
awuvalile	a w u v a l i l E
ay	a j
ayababa	a j a b_< a b_< a
aye	a j E
ayenze	a j E n z E
ayi	a j i
ayibone	a j i b_< O n E
ayikhambi	a j i k_h a m b i
ayikho	a j i k_h O
ayikhomba	a j i k_h O m b a
ayilungise	a j i l u N g i s E
ayinamsebe	a j i n a m s E b_< E
ayinamsebenz	a j i n a m s E b_< E n z
ayinamsebenzi	a j i n a m s E b_< E n z i
ayingena	a j i N g E n a
ayisithandathu	a j i s i t_h a n d a t_h u
ayithathe	a j i t_h a t_h E
ayithoba	a j i t_h O b_< a
ayitjhumi	a j i tS_h u m i
ayo	a j O
ayokufika	a j O k u f i k a
ayokufuna	a j O k u f u n a
ayokuqala	a j O k u !_b a l a
ayoyilungisa	a j O j i l u N g i s a
ayuyele	a j u j E l E
azange	a z a N g E
azirubele	a z i r u b_< E l E
azisa	a z i s a
azisahlaliseki	a z i s a K a l i s E k i
azokwazi	a z O k w a z i
azongihlangabeza	a z O N g i K a N g a b_< E z a
azumela	a z u m E l a
b	b_<
ba	b_< a
baba	b_< a b_< a
babaj	b_< a b_< a d_0Z
babajayele	b_< a b_< a d_0Z a j E l E
babamkhulu	b_< a b_< a m k_h u l u
babathole	b_< a b_< a t_h O l E
babe	b_< a b_< E
babebafihla	b_< a b_< E b_< a f i K a
babhu	b_< a b u
babona	b_< a b_< O n a
babuzana	b_< a b_< u z a n a
babuze	b_< a b_< u z E
babuzwe	b_< a b_< u z w E
baduduzana	b_< a d u d u z a n a
bafanele	b_< a f a n E l E
bafi	b_< a f i
bafihla	b_< a f i K a
bafihle	b_< a f i K E
bafike	b_< a f i k E
bafikelwa	b_< a f i k E l w a
bafikile	b_< a f i k i l E
bafuna	b_< a f u n a
bagijimi	b_< a g i d_0Z i m i
bagijimisane	b_< a g i d_0Z i m i s a n E
bagugudlhele	b_< a g u g u K_b E l E
bah	b_< a
bahleba	b_< a K E b_< a
bahleka	b_< a K E k a
bahlezi	b_< a K E z i
bahlinze	b_< a K i n z E
bahlukane	b_< a K u k a n E
bajaji	b_< a d_0Z a d_0Z i
bajatjuliswe	b_< a d_0Z a tS_h d_0Z u l i s w E
baje	b_< a d_0Z E
bak	b_< a k
bakadavi	b_< a k a d a v i
bakadavidi	b_< a k a d a v i d i
bakana	b_< a k a n a
bakanamtshweni	b_< a k a n a m ts_h w E n i
bakanomzana	b_< a k a n O m z a n a
bakh	b_< a k_h
bakha	b_< a k_h a
bakhawukelwe	b_< a k_h a w u k E l w E
bakhawule	b_< a k_h a w u l E
bakhazingele	b_< a k_h a z i N g E l E
bakhe	b_< a k_h E
bakhona	b_< a k_h O n a
bakhukhutha	b_< a k_h u k_h u t_h a
bakhukhuthe	b_< a k_h u k_h u t_h E
bakhuluma	b_< a k_h u l u m a
baklarela	b_< a k l a r E l a
bako	b_< a k O
bakonomzana	b_< a k O n O m z a n a
bakudzwebula	b_< a k u dz w E b_< u l a
bala	b_< a l a
balambile	b_< a l a m b i l E
balayelisane	b_< a l a j E l i s a n E
balinga	b_< a l i N g a
bam	b_< a m
bama	b_< a m a
bamazi	b_< a m a z i
bambethe	b_< a m b E t_h E
bamkhangi	b_< a m k_h a N g i
bamkhanzingele	b_< a m k_h a n z i N g E l E
bamlisa	b_< a m l i s a
bamnikela	b_< a m n i k E l a
banesibindi	b_< a n E s i b_< i n d i
banga	b_< a N g a
bangakabuyi	b_< a N g a k a b_< u j i
bangakazwisisi	b_< a N g a k a z w i s i s i
bangakhuthaz	b_< a N g a k_h u t_h a z
bangakhuthazwa	b_< a N g a k_h u t_h a z w a
bangakudwebula	b_< a N g a k u d w E b_< u l a
bangakuth	b_< a N g a k u t_h
bangakutha	b_< a N g a k u t_h a
bangam	b_< a N g a m
bangamvalela	b_< a N g a m v a l E l a
bangamvelela	b_< a N g a m v E l E l a
banganelise	b_< a N g a n E l i s E
banganeliseka	b_< a N g a n E l i s E k a
bangangena	b_< a N g a N g E n a
bangangi	b_< a N g a N g i
bangangirhawuke	b_< a N g a N g i x a w u k E
bangangirhawukeli	b_< a N g a N g i x a w u k E l i
bangas	b_< a N g a s
bangasabuyi	b_< a N g a s a b_< u j i
bangasi	b_< a N g a s i
bangazwisisi	b_< a N g a z w i s i s i
bangirhawukele	b_< a N g i x a w u k E l E
bani	b_< a n i
banje	b_< a n d_0Z E
banokusabanyana	b_< a n O k u s a b_< a J a n a
banomrharibakhe	b_< a n O m x a r i b_< a k_h E
banonatlharini	b_< a n O n a tK_h a r i n i
banoskhosana	b_< a n O s k_h O s a n a
baqede	b_< a !_b E d E
baragele	b_< a r a g E l E
barham	b_< a x a m
barhamula	b_< a x a m u l a
basebudisini	b_< a s E b_< u d i s i n i
basiya	b_< a s i j a
bath	b_< a t_h
bathaba	b_< a t_h a b_< a
bathatha	b_< a t_h a t_h a
bathatjiswe	b_< a t_h a tS_> i s w E
bathi	b_< a t_h i
bathokoze	b_< a t_h O k O z E
bathom	b_< a t_h O m
bathoma	b_< a t_h O m a
bathome	b_< a t_h O m E
bathomeke	b_< a t_h O m E k E
bathomile	b_< a t_h O m i l E
bathwele	b_< a t_h w E l E
batjho	b_< a tS_h O
batlarhela	b_< a tK_> a x E l a
bavimbana	b_< a v i m b a n a
bavuke	b_< a v u k E
bavumelana	b_< a v u m E l a n a
bavuswa	b_< a v u s w a
bay	b_< a j
baya	b_< a j a
bayacoca	b_< a j a |_b O |_b a
bayalobola	b_< a j a l O b_< O l a
bayamhleka	b_< a j a m K E k a
bayaphikisana	b_< a j a p_h i k i s a n a
bayathombisa	b_< a j a t_h O m b i s a
bayazama	b_< a j a z a m a
bayazana	b_< a j a z a n a
baye	b_< a j E
bayeqayeqa	b_< a j E !_b a j E !_b a
bayezam	b_< a j E z a m
bayijhi	b_< a j i d_0Z i
bayirhuluphele	b_< a j i x u l u p_h E l E
bayise	b_< a j i s E
bayitjhiye	b_< a j i tS_h i j E
bayiya	b_< a j i j a
bayo	b_< a j O
bayokungena	b_< a j O k u N g E n a
bayom	b_< a j O m
bayomtjhiya	b_< a j O m tS_h i j a
baziba	b_< a z i b_< a
bazibambe	b_< a z i b_< a m b E
bazijayeze	b_< a z i d_0Z a j E z E
bazikg	b_< a z i kx g
bazikghonako	b_< a z i kx O n a k O
bazomhlola	b_< a z O m K O l a
be	b_< E
bebayaphoqan	b_< E b_< a j a p_h O !_b a n
bebayaphoqana	b_< E b_< a j a p_h O !_b a n a
bebayo	b_< E b_< a j O
bebayokungena	b_< E b_< a j O k u N g E n a
bebayokuphoqan	b_< E b_< a j O k u p_h O !_b a n
bebeyongena	b_< E b_< E j O N g E n a
beenghonghoyilo	b_< E N O N O j i l O
beenhloko	b_< E n K O k O
befuthi	b_< E f u t_h i
begodu	b_< E g O d u
behlo	b_< E K O
behlobo	b_< E K O b_< O
behlukaniseka	b_< E K u k a n i s E k a
bekahlezi	b_< E k a K E z i
bekakuthole	b_< E k a k u t_h O l E
bekaqhaqhana	b_< E k a !_bh a !_bh a n a
bekerege	b_< E k E r E g E
bekh	b_< E k_h
bekhakwakhe	b_< E k_h a k w a k_h E
beku	b_< E k u
bekube	b_< E k u b_< E
bekumsan	b_< E k u m s a n
bekumsana	b_< E k u m s a n a
bekungathi	b_< E k u N g a t_h i
bekuthi	b_< E k u t_h i
bekuthu	b_< E k u t_h u
bekuthuthumba	b_< E k u t_h u t_h u m b a
bekuyo	b_< E k u j O
bel	b_< E l
belfast	b_< E l f a s t_h
belinqophene	b_< E l i n !_b O p_h E n E
ben	b_< E n
benghonghoyilo	b_< E N O N O j i l O
bengi	b_< E N g i
bengingeze	b_< E N g i N g E z E
benza	b_< E n z a
benze	b_< E n z E
benziwa	b_< E n z i w a
beqayeqa	b_< E !_b a j E !_b a
beroma	b_< E r O m a
besala	b_< E s a l a
besana	b_< E s a n a
bese	b_< E s E
besele	b_< E s E l E
besiye	b_< E s i j E
bethal	b_< E t_h a l
bewagade	b_< E w a g a d E
bewagandelela	b_< E w a g a n d E l E l a
bewu	b_< E w u
bewuphe	b_< E w u p_h E
bewuphenjwa	b_< E w u p_h E n d_0Z w a
beyak	b_< E j a k
beyetjelwa	b_< E j E tS_> E l w a
beyiya	b_< E j i j a
beyiyincani	b_< E j i j i n |_b a n i
beza	b_< E z a
bezingeze	b_< E z i N g E z E
bezwa	b_< E z w a
bezwe	b_< E z w E
bhala	b a l a
bhasketi	b a s k E t_> i
bheni	b E n i
bhi	b i
bi	b_< i
bili	b_< i l i
bobabili	b_< O b_< a b_< i l i
boke	b_< O k E
boksburg	b_< O k s b_< u r g
bomlomo	b_< O m l O m O
bon	b_< O n
bona	b_< O n a
bonakele	b_< O n a k E l E
bonamrharibakhe	b_< O n a m x a r i b_< a k_h E
bonke	b_< O N k E
bonom	b_< O n O m
bonyana	b_< O J a n a
bonye	b_< O J E
boskhosana	b_< O s k_h O s a n a
boven	b_< O v E n
bowuphenjwa	b_< O w u p_h E n d_0Z w a
boyce	b_< O j |_b E
breyten	b_< r E j t_> E n
bronghoro	b_< r O N O r O
bronkhorspruit	b_< r O N k_h O r s p_h r u i t_h
bronkhorstsprui	b_< r O N k_h O r s ts_> p_h r u i
bronkhorstspruit	b_< r O N k_h O r s ts_> p_h r u i t_h
bronkhortspruit	b_< r O N k_h O r ts_> p_h r u i t_h
bronkoorspruit	b_< r O N k_> O O r s p_h r u i t_h
bu	b_< u
bubuhle	b_< u b_< u K E
buhla	b_< u K a
buhlak	b_< u K a k
buhlakanis	b_< u K a k a n i s
buhlebesizwe	b_< u K E b_< E s i z w E
buhlukanisa	b_< u K u k a n i s a
buhlukaniseka	b_< u K u k a n i s E k a
buhlukaniswe	b_< u K u k a n i s w E
buhlunganiseka	b_< u K u N g a n i s E k a
bumnini	b_< u m n i n i
bun	b_< u n
buna	b_< u n a
bunane	b_< u n a n E
buvuruvu	b_< u v u r u v u
buvuruvuru	b_< u v u r u v u r u
carolina	|_b a r O l i n a
caroline	|_b a r O l i n E
colt	|_b O l t_h
cullinan	|_b u l l i n a n
d	d
daba	d a b_< a
datjalala	d a tS_> a l a l a
datjhalala	d a tS_h a l a l a
delmas	d E l m a s
delmasi	d E l m a s i
delmus	d E l m u s
denillton	d E n i l l t_> O n
dennilton	d E n n i l t_> O n
denniltono	d E n n i l t_> O n O
desh	d E s
di	d i
dindilizele	d i n d i l i z E l E
dindizile	d i n d i z i l E
dinini	d i n i n i
district	d i s t_h r i |_b t_h
dladla	K_b a K_b a
doornkop	d O O r N k_> O p_h
doringkop	d O r i N g k O p_h
dorobhen	d O r O b E n
dorobheni	d O r O b E n i
du	d u
e	E
east	E a s t_h
eb	E b_<
eba	E b_< a
ebantwaneni	E b_< a n t_> w a n E n i
ebasizako	E b_< a s i z a k O
ebasizayo	E b_< a s i z a j O
ebayibiza	E b_< a j i b_< i z a
ebe	E b_< E
ebeka	E b_< E k a
ebekade	E b_< E k a d E
ebekanayo	E b_< E k a n a j O
ebengikiwo	E b_< E N g i k i w O
ebese	E b_< E s E
ebeze	E b_< E z E
ebezwana	E b_< E z w a n a
ebezwen	E b_< E z w E n
ebh	E b
ebhosa	E b O s a
ebhu	E b u
ebhudwini	E b u d w i n i
ebhundu	E b u n d u
ebikade	E b_< i k a d E
ebizwa	E b_< i z w a
ebodeni	E b_< O d E n i
ebronghoro	E b_< r O N O r O
ebu	E b_< u
ebuhlungu	E b_< u K u N g u
ebukisako	E b_< u k i s a k O
ebulalisa	E b_< u l a l i s a
ebunane	E b_< u n a n E
ebunaneni	E b_< u n a n E n i
ebusika	E b_< u s i k a
ebuwaneni	E b_< u w a n E n i
ecabazi	E |_b a b_< a z i
ecabazini	E |_b a b_< a z i n i
edibizese	E d i b_< i z E s E
edini	E d i n i
edinini	E d i n i n i
edisibeze	E d i s i b_< E z E
edorobheni	E d O r O b E n i
edrakansteni	E d r a k a n s t_> E n i
eduzane	E d u z a n E
eduze	E d u z E
eembadeni	E m b a d E n i
eembhesini	E m b E s i n i
eembili	E m b i l i
eemodereni	E m O d E r E n i
eentaben	E n t_> a b_< E n
eentabeni	E n t_> a b_< E n i
eentandeni	E n t_> a n d E n i
ef	E f
efa	E f a
efan	E f a n
efandesini	E f a n d E s i n i
efuk	E f u k
efuku	E f u k u
efukufukwini	E f u k u f u k w i n i
efukuw	E f u k u w
efukwini	E f u k w i n i
efun	E f u n
efuna	E f u n a
efuthumela	E f u t_h u m E l a
ega	E g a
egarankuwa	E g a r a N k_> u w a
ehla	E K a
ehlanganiswe	E K a N g a n i s w E
ehliziyweni	E K i z i j w E n i
ehlo	E K O
ehloko	E K O k O
ehotela	E h O t_> E l a
eje	E d_0Z E
ekalafoni	E k a l a f O n i
ekangal	E k_> a N g a l
ekangala	E k_> a N g a l a
ekapa	E k a p_> a
ekarisako	E k a r i s a k O
ekha	E k_h a
ekhab	E k_h a b_<
ekhabo	E k_h a b_< O
ekhaya	E k_h a j a
ekhayapha	E k_h a j a p_h a
ekhela	E k_h E l a
ekhiwe	E k_h i w E
ekhomba	E k_h O m b a
ekhombako	E k_h O m b a k O
ekhulwini	E k_h u l w i n i
ekhuweni	E k_h u w E n i
ekosini	E k_> O s i n i
eku	E k u
ekufanele	E k u f a n E l E
ekufuna	E k u f u n a
ekufuze	E k u f u z E
ekulungwaneni	E k_> u l u N g w a n E n i
ekungazange	E k u N g a z a N g E
ekungiwo	E k u N g i w O
ekuqiniseni	E k u !_b i n i s E n i
ekuseni	E k_> u s E n i
ekuthiwa	E k_> u t_h i w a
ekutho	E k_> u t_h O
ekuthomeni	E k_> u t_h O m E n i
ekuza	E k u z a
ekuzange	E k u z a N g E
ekwendeni	E k w E n d E n i
el	E l
ela	E l a
elangeni	E l a N g E n i
elayibrari	E l a j i b_< r a r i
ele	E l E
eleke	E l E k E
eli	E l i
elibizwa	E l i b_< i z w a
elibowakgom	E l i b_< O w a kx g O m
elidephileko	E l i d E p_h i l E k O
elijayelekileko	E l i d_0Z a j E l E k i l E k O
elikarisako	E l i k a r i s a k O
elikhomba	E l i k_h O m b a
elikhulu	E l i k_h u l u
elilande	E l i l a n d E
elilandelako	E l i l a n d E l a k O
elilodwa	E l i l O d w a
elim	E l i m
elimasumi	E l i m a s u m i
elimatjhi	E l i m a tS_h i
elimatjhum	E l i m a tS_h u m
elimatjhumi	E l i m a tS_h u m i
elimini	E l i m i n i
elinamatjhumi	E l i n a m a tS_h u m i
elinye	E l i J E
eliph	E l i p_h
elipholileko	E l i p_h O l i l E k O
eliqophileko	E l i !_b O p_h i l E k O
eliseqadi	E l i s E !_b a d i
elisumi	E l i s u m i
elith	E l i t_h
elithileko	E l i t_h i l E k O
elitho	E l i t_h O
elithoba	E l i t_h O b_< a
elithobako	E l i t_h O b_< a k O
elitjhumi	E l i tS_h u m i
eliveli	E l i v E l i
eliveni	E l i v E n i
elizijameleko	E l i z i d_0Z a m E l E k O
elu	E l u
em	E m
ema	E m a
emabili	E m a b_< i l i
emabuyeni	E m a b_< u j E n i
emadla	E m a K_b a
emadlangeni	E m a K_b a N g E n i
emagomedzwana	E m a g O m E dz w a n a
emakhulwini	E m a k_h u l w i n i
emalangeni	E m a l a N g E n i
emane	E m a n E
emaphodlha	E m a p_h O K_b a
emaplas	E m a p_h l a s
emaplasini	E m a p_h l a s i n i
emaqanda	E m a !_b a n d a
emarharha	E m a x a x a
emasumame	E m a s u m a m E
emasumi	E m a s u m i
ematjhu	E m a tS_h u
ematjhumi	E m a tS_h u m i
ematjhumini	E m a tS_h u m i n i
embathe	E m b a t_h E
emberegweni	E m b E r E g w E n i
embethe	E m b E t_h E
emciphepheni	E m |_b i p_h E p_h E n i
emdlalweni	E m K_b a l w E n i
emedlhela	E m E K_b E l a
emehlwenami	E m E K w E n a m i
emehlweni	E m E K w E n i
emhlanganweni	E m K a N g a n w E n i
emhluzi	E m K u z i
emi	E m i
emide	E m i d E
emigodini	E m i g O d i n i
emihlanu	E m i K a n u
emine	E m i n E
eminengi	E m i n E N g i
emini	E m i n i
eminyakeni	E m i J a k E n i
emitha	E m i t_h a
emithathu	E m i t_h a t_h u
emjekeni	E m E k E n i
emkgheledzwana	E m kx E l E dz w a n a
emkobo	E m k O b_< O
emkobol	E m k O b_< O l
emkobola	E m k O b_< O l a
emkobolo	E m k O b_< O l O
emlandweni	E m l a n d w E n i
emlandwini	E m l a n d w i n i
emnqi	E m n !_b i
emntatweni	E m n t_> a t_> w E n i
emntwant	E m n t_> w a n t_>
emnyakeni	E m J a k E n i
emphakathini	E m p_h a k a t_h i n i
emporofidini	E m p_> O r O f i d i n i
empumalanga	E m p_> u m a l a N g a
emqiph	E m !_b i p_h
emqipheni	E m !_b i p_h E n i
emqiphepheni	E m !_b i p_h E p_h E n i
emqiphephepheni	E m !_b i p_h E p_h E p_h E n i
emqiphi	E m !_b i p_h i
emrarweni	E m r a r w E n i
emrhaleni	E m x a l E n i
emrhononweni	E m x O n O n w E n i
emsebenzi	E m s E b_< E n z i
emsebenzini	E m s E b_< E n z i n i
emtatweni	E m t_> a t_> w E n i
emthambothini	E m t_h a m b O t_h i n i
emthandazwe	E m t_h a n d a z w E
emthandazweni	E m t_h a n d a z w E n i
emthi	E m t_h i
emthini	E m t_h i n i
emtholampilo	E m t_h O l a m p_> i l O
emthunzaneni	E m t_h u n z a n E n i
emtjekeni	E m tS_> E k E n i
emtlolweni	E m tK_> O l w E n i
emudeni	E m u d E n i
emum	E m u m
emumethwe	E m u m E t_h w E
emuntwini	E m u n t_> w i n i
emuva	E m u v a
emva	E m v a
emzimbe	E m z i m b E
emzimbeni	E m z i m b E n i
emzini	E m z i n i
en	E n
enamatjhumi	E n a m a tS_h u m i
enarheni	E n a x E n i
enda	E n d a
endaweni	E n d a w E n i
endedema	E n d E d E m a
endleleni	E n K_b E l E n i
endlwane	E n K_b w a n E
endlwaneni	E n K_b w a n E n i
endlwanin	E n K_b w a n i n
endunwuni	E n d u n w u n i
endwani	E n d w a n i
eneenkomo	E n E N k O m O
eneenkukhu	E n E N k u k_h u
enemi	E n E m i
engabethelwa	E N g a b_< E t_h E l w a
engamasumi	E N g a m a s u m i
engamatjhumi	E N g a m a tS_h u m i
engaphandle	E N g a p_h a n K_b E
engcono	E N |_bg O n O
enge	E N g E
engeman	E N g E m a n
engena	E N g E n a
engeyakhe	E N g E j a k_h E
engingo	E N g i N g O
engizothathelwa	E N g i z O t_h a t_h E l w a
engizoz	E N g i z O z
engusewula	E N g u s E w u l a
enikela	E n i k E l a
enku	E N k_> u
enoboya	E n O b_< O j a
enqotjhiswe	E n !_b O tS_h i s w E
enqwa	E n !_b w a
enya	E J a
enyakeni	E J a k_> E n i
enyangeni	E J a N g E n i
ephambili	E p_h a m b i l i
ephezulu	E p_h E z u l u
ephikisana	E p_h i k i s a n a
ephikisanako	E p_h i k i s a n a k O
epholileko	E p_h O l i l E k O
ephugu	E p_h u g u
epi	E p_> i
epito	E p_> i t_> O
epitor	E p_> i t_> O r
epitori	E p_> i t_> O r i
eplasini	E p_h l a s i n i
epompi	E p_> O m p_> i
epompini	E p_> O m p_> i n i
epretori	E p_h r E t_> O r i
epumalanga	E p_> u m a l a N g a
eqinisweni	E !_b i n i s w E n i
erholwe	E x O l w E
erholweni	E x O l w E n i
ermelo	E r m E l O
es	E s
esa	E s a
esahlongozwako	E s a K O N g O z w a k O
esaku	E s a k u
ese	E s E
esele	E s E l E
esemakhaya	E s E m a k_h a j a
esenziwa	E s E n z i w a
esenzweni	E s E n z w E n i
esewula	E s E w u l a
esezisitjhiyileko	E s E z i s i tS_h i j i l E k O
esi	E s i
esibhedlela	E s i b E K_b E l a
esibuyekeziweko	E s i b_< u j E k E z i w E k O
esibuyeki	E s i b_< u j E k i
esibuyel	E s i b_< u j E l
esichotjeni	E s i |_bh O tS_> E n i
eside	E s i d E
esidulini	E s i d u l i n i
esifundeni	E s i f u n d E n i
esiginindeni	E s i g i n i n d E n i
esikhawin	E s i k_h a w i n
esikhuluma	E s i k_h u l u m a
esikhuweni	E s i k_h u w E n i
esikolwe	E s i k_> O l w E
esikolwen	E s i k_> O l w E n
esikolweni	E s i k_> O l w E n i
esikwaziko	E s i k w a z i k O
esimavelede	E s i m a v E l E d E
esina	E s i n a
esinabantu	E s i n a b_< a n t_> u
esindebele	E s i n d E b_< E l E
esingaka	E s i N g a k a
esiphandeni	E s i p_h a n d E n i
esiq	E s i !_b
esiqweni	E s i !_b w E n i
esiqwini	E s i !_b w i n i
esithandathu	E s i t_h a n d a t_h u
esithi	E s i t_h i
esithlagwa	E s i t_h K a g w a
esitulweni	E s i t_> u l w E n i
esiwu	E s i w u
esiwukhomba	E s i w u k_h O m b a
esiwukhombako	E s i w u k_h O m b a k O
esiyabu	E s i j a b_< u
esiyabus	E s i j a b_< u s
esiyabusw	E s i j a b_< u s w
esiyabuswa	E s i j a b_< u s w a
esiyitsitsirimba	E s i j i ts_> i ts_> i r i m b a
esiyo	E s i j O
esiyozenza	E s i j O z E n z a
esizitjhiyileko	E s i z i tS_h i j i l E k O
esizoyenza	E s i z O j E n z a
esoshanguve	E s O s a N g u v E
et	E t_h
eta	E t_> a
etafule	E t_> a f u l E
etafuleni	E t_> a f u l E n i
eteyi	E t_> E j i
eth	E t_h
ethabana	E t_h a b_< a n a
ethi	E t_h i
ethile	E t_h i l E
ethileko	E t_h i l E k O
ethno	E t_h n O
ethnological	E t_h n O l O g i |_b a l
ethobako	E t_h O b_< a k O
ethono	E t_h O n O
ethu	E t_h u
ethunzaneni	E t_h u n z a n E n i
ethwele	E t_h w E l E
etjanini	E tS_> a n i n i
etlolwe	E tK_> O l w E
etshwane	E ts_h w a n E
eval	E v a l
evikilini	E v i k_> i l i n i
eya	E j a
eyabhala	E j a b a l a
eyenziwe	E j E n z i w E
eyi	E j i
eyiko	E j i k O
eyikulungwana	E j i k_> u l u N g w a n a
eyinkulungwana	E j i N k_> u l u N g w a n a
ez	E z
ezagcwalisa	E z a !_bg w a l i s a
ezako	E z a k O
ezenzweni	E z E n z w E n i
ezi	E z i
ezibukhali	E z i b_< u k_h a l i
ezifitjhani	E z i f i tS_h a n i
eziga	E z i g a
ezigandelela	E z i g a n d E l E l a
ezihlanu	E z i K a n u
ezihle	E z i K E
eziko	E z i k O
ezilayitjhiweko	E z i l a j i tS_h i w E k O
ezilisumi	E z i l i s u m i
ezim	E z i m
ezimakghwakghwa	E z i m a kx w a kx w a
ezimakghwakghwatha	E z i m a kx w a kx w a t_h a
ezimavelede	E z i m a v E l E d E
ezimaz	E z i m a z
ezimbili	E z i m b i l i
ezimku	E z i m k u
ezimlukuluku	E z i m l u k u l u k u
ezinamakonyana	E z i n a m a k O J a n a
ezine	E z i n E
ezing	E z i N g
ezinga	E z i N g a
ezingaka	E z i N g a k a
ezingakavuth	E z i N g a k a v u t_h
ezingakavuthwa	E z i N g a k a v u t_h w a
ezingehla	E z i N g E K a
ezintathu	E z i n t_> a t_h u
ezintweni	E z i n t_> w E n i
ezinye	E z i J E
eziqakatheke	E z i !_b a k a t_h E k E
eziqakatheki	E z i !_b a k a t_h E k i
eziqakathekileko	E z i !_b a k a t_h E k i l E k O
ezisele	E z i s E l E
ezithinta	E z i t_h i n t_> a
ezitjha	E z i tS_h a
ezitjhisako	E z i tS_h i s a k O
ezitjhiye	E z i tS_h i j E
ezitjhiyileko	E z i tS_h i j i l E k O
ezitjho	E z i tS_h O
ezizijameleko	E z i z i d_0Z a m E l E k O
ezuma	E z u m a
ezwana	E z w a n a
ezwe	E z w E
f	f
fana	f a n a
ferndale	f E r n d a l E
five	f i v E
foreign	f O r E i g n
fukwini	f u k w i n i
futhi	f u t_h i
g	g
ga	g a
gadesi	g a d E s i
gandelela	g a n d E l E l a
garlina	g a r l i n a
gauteng	g a u t_> E N g
genu	g E n u
germiston	g E r m i s t_> O n
ghonako	O n a k O
ginya	g i J a
giz	g i z
go	g O
godi	g O d i
godu	g O d u
gokunukelela	g O k u n u k E l E l a
government	g O v E r n m E n t_>
gqi	!_bg i
grammatical	g r a m m a t_> i |_b a l
groblersdal	g r O b_< l E r s d a l
gu	g u
h	h
hall	h a l l
hammanskraal	h a m m a n s k r a a l
hendrina	h E n d r i n a
heyi	h E j i
hlala	K a l a
hlale	K a l E
hlan	K a n
hlangana	K a N g a n a
hlanu	K a n u
hlawulani	K a w u l a n i
hlokwana	K O k w a n a
hlolanja	K O l a n d_0Z a
ho	h O
hospital	h O s p_> i t_> a l
i	i
ib	i b_<
ibange	i b_< a N g E
iberegiswa	i b_< E r E g i s w a
ibha	i b a
ibhaga	i b a g a
ibhanga	i b a N g a
ibhange	i b a N g E
ibhrakufesi	i b r a k u f E s i
ibhrekufasti	i b r E k u f a s t_> i
ibiko	i b_< i k O
ibisi	i b_< i s i
ibiza	i b_< i z a
ibutho	i b_< u t_h O
idarada	i d a r a d a
idorobha	i d O r O b a
idose	i d O s E
idzila	i dz i l a
if	i f
ifahle	i f a K E
ifakwe	i f a k w E
ifana	i f a n a
ifanana	i f a n a n a
ifi	i f i
ifika	i f i k a
ifukame	i f u k a m E
ifukamela	i f u k a m E l a
ifundwe	i f u n d w E
ifuyo	i f u j O
igodlana	i g O K_b a n a
igwayi	i g w a j i
igwebu	i g w E b_< u
ihlabathi	i K a b_< a t_h i
ihli	i K i
ihliziyo	i K i z i j O
ihliziywakhe	i K i z i j w a k_h E
ihloko	i K O k O
iiintolo	i n t_> O l O
iim	i m
iimbonelo	i m b O n E l O
iimbontjisi	i m b O n tS_h i s i
iimbuz	i m b u z
iimbuzi	i m b u z i
iimemezelo	i m E m E z E l O
iimfene	i m f E n E
iimfiso	i m f i s O
iimfundafunda	i m f u n d a f u n d a
iimpendu	i m p_> E n d u
iimpendulo	i m p_> E n d u l O
iimphu	i m p_h u
iimphuraphura	i m p_h u r a p_h u r a
iimpisi	i m p_> i s i
iimvumelwano	i m v u m E l w a n O
iin	i n
iinda	i n d a
iindawo	i n d a w O
iindunwezi	i n d u n w E z i
iingajana	i N g a d_0Z a n a
iingatjana	i N g a tS_> a n a
iingubo	i N g u b_< O
iingulani	i N g u l a n i
iinhloko	i n K O k O
iinhluthu	i n K u t_h u
iink	i N k
iinkhwede	i N k_h w E d E
iinkhwele	i N k_h w E l E
iinkhwende	i N k_h w E n d E
iinko	i N k_> O
iinkobe	i N k_> O b_< E
iinkom	i N k_> O m
iinkomezo	i N k_> O m E z O
iinkomo	i N k_> O m O
iinkophe	i N k_> O p_h E
iinkotlelo	i N k_> O tK_> E l O
iinkukhu	i N k_> u k_h u
iinkululungwana	i N k_> u l u l u N g w a n a
iinkulumiswano	i N k_> u l u m i s w a n O
iinlodlhelo	i n l O K_b E l O
iinlori	i n l O r i
iinlwa	i n l w a
iinlwan	i n l w a n
iinlwana	i n l w a n a
iinqe	i n !_b E
iinqhema	i n !_bh E m a
iinqhembu	i n !_bh E m b u
iinqunto	i n !_b u n t_> O
iinrarejo	i n r a r E d_0Z O
iinsebenzi	i n s E b_< E n z i
iintanga	i n t_> a N g a
iintlhogeko	i n tK_h O g E k O
iintolo	i n t_> O l O
iintombi	i n t_> O m b i
iintonga	i n t_> O N g a
iinunwana	i n u n w a n a
iinyamazana	i J a m a z a n a
iinyanga	i J a N g a
iinyembezi	i J E m b E z i
ijame	i d_0Z a m E
ijini	i d_0Z i n i
ijinifomu	i d_0Z i n i f O m u
ikabitini	i k_> a b_< i t_> i n i
ikamero	i k_> a m E r O
ikasi	i k_> a s i
ikhabitjhi	i k_h a b_< i tS_h i
ikhala	i k_h a l a
ikhamba	i k_h a m b a
ikharikhyulamu	i k_h a r i k_h j u l a m u
ikhowe	i k_h O w E
ikhuno	i k_h u n O
iko	i k_> O
ikoloyi	i k_> O l O j i
ikomitjhini	i k_> O m i tS_h i n i
ikomo	i k_> O m O
ikondlo	i k_> O n K_b O
ikosi	i k_> O s i
ikulumo	i k_> u l u m O
ikulungwana	i k_> u l u N g w a n a
il	i l
ilandelwa	i l a n d E l w a
ilanga	i l a N g a
ili	i l i
ilimi	i l i m i
ilimu	i l i m u
ilithi	i l i t_h i
ilitjhumi	i l i tS_h u m i
ilize	i l i z E
ilizwe	i l i z w E
ilizwi	i l i z w i
ilori	i l O r i
ilwazi	i l w a z i
im	i m
ima	i m a
imadlana	i m a K_b a n a
imal	i m a l
imali	i m a l i
imatjhumi	i m a tS_h u m i
imbaw	i m b a w
imbawula	i m b a w u l a
imbubulo	i m b u b_< u l O
imfunde	i m f u n d E
imhlazana	i m K a z a n a
imhluzi	i m K u z i
imi	i m i
imibuzo	i m i b_< u z O
imidlalo	i m i K_b a l O
imigo	i m i g O
imigom	i m i g O m
imigomudlha	i m i g O m u K_b a
imik	i m i k
imikarisomraro	i m i k a r i s O m r a r O
imikukurumbu	i m i k u k u r u m b u
imilandu	i m i l a n d u
imilayo	i m i l a j O
imilenze	i m i l E n z E
imini	i m i n i
iminyaka	i m i J a k a
iminyakami	i m i J a k a m i
iminyango	i m i J a N g O
imiq	i m i !_b
imiqondo	i m i !_b O n d O
imisebenzi	i m i s E b_< E n z i
imithetho	i m i t_h E t_h O
imithwa	i m i t_h w a
imithwadlana	i m i t_h w a K_b a n a
imitlolo	i m i tK_> O l O
imiz	i m i z
imiza	i m i z a
imizabo	i m i z a b_< O
imizana	i m i z a n a
imizi	i m i z i
imizuzu	i m i z u z u
imle	i m l E
imlenze	i m l E n z E
imphuraphura	i m p_h u r a p_h u r a
imu	i m u
imuk	i m u k
imukarisamraro	i m u k a r i s a m r a r O
imukariso	i m u k a r i s O
imukasi	i m u k a s i
imvelo	i m v E l O
in	i n
inamalanga	i n a m a l a N g a
inarha	i n a x a
incwadi	i n |_b w a d i
ind	i n d
indaba	i n d a b_< a
indawana	i n d a w a n a
indawo	i n d a w O
indebele	i n d E b_< E l E
indlela	i n K_b E l a
indlhela	i n K_b E l a
indoda	i n d O d a
indodakazi	i n d O d a k a z i
ine	i n E
ing	i N g
inga	i N g a
ingani	i N g a n i
ingathengisa	i N g a t_h E N g i s a
ingathengiswa	i N g a t_h E N g i s w a
ingatjana	i N g a tS_> a n a
ingena	i N g E n a
ingenzeni	i N g E n z E n i
ingqondwakhe	i N !_bg O n d w a k_h E
ingwema	i N g w E m a
ingwemabala	i N g w E m a b_< a l a
ini	i n i
inkulungwane	i N k_> u l u N g w a n E
inombala	i n O m b a l a
inrhwa	i n x w a
institjuti	i n s t_> i tS_h d_0Z u t_> i
intangana	i n t_> a N g a n a
inter	i n t_> E r
interference	i n t_> E r f E r E n |_b E
interferences	i n t_> E r f E r E n |_b E s
interferencing	i n t_> E r f E r E n |_b i N g
into	i n t_> O
intuthu	i n t_> u t_h u
inyamaza	i J a m a z a
inyamazana	i J a m a z a n a
inyanga	i J a N g a
ip	i p_h
ipahla	i p_> a K a
ipalapala	i p_> a l a p_> a l a
ipama	i p_> a m a
ipendu	i p_> E n d u
ipendulo	i p_> E n d u l O
ipha	i p_h a
iphele	i p_h E l E
iphepha	i p_h E p_h a
iphethwe	i p_h E t_h w E
iphihli	i p_h i K i
iphihlikile	i p_h i K i k i l E
iphiko	i p_h i k O
ipi	i p_> i
ipisi	i p_> i s i
iplasi	i p_h l a s i
ipulasi	i p_> u l a s i
ipungutjha	i p_> u N g u tS_h a
iqanda	i !_b a n d a
iqatjhazi	i !_b a tS_h a z i
iqi	i !_b i
iqiniso	i !_b i n i s O
iresiphi	i r E s i p_h i
irhaba	i x a b_< a
irhabh	i x a b
irhabha	i x a b a
irharideni	i x a r i d E n i
irherho	i x E x O
irhubhululo	i x u b u l u l O
irhwanda	i x w a n d a
irhwanqa	i x w a n !_b a
iri	i r i
irogweli	i r O g w E l i
is	i s
isa	i s a
isaga	i s a g a
isala	i s a l a
isandla	i s a n K_b a
isi	i s i
isib	i s i b_<
isibaya	i s i b_< a j a
isibonelo	i s i b_< O n E l O
isifiso	i s i f i s O
isifuba	i s i f u b_< a
isifundo	i s i f u n d O
isigaba	i s i g a b_< a
isigcila	i s i |_bg i l a
isigodo	i s i g O d O
isihlahlesi	i s i K a K E s i
isikhala	i s i k_h a l a
isikhathi	i s i k_h a t_h i
isikhukhukazi	i s i k_h u k_h u k a z i
isikhumba	i s i k_h u m b a
isiko	i s i k_> O
isikolo	i s i k_> O l O
isilevana	i s i l E v a n a
isilukazi	i s i l u k a z i
isinanja	i s i n a n d_0Z a
isindebe	i s i n d E b_< E
isindebel	i s i n d E b_< E l
isindebele	i s i n d E b_< E l E
isingeniso	i s i N g E n i s O
isiphakamiso	i s i p_h a k a m i s O
isiphan	i s i p_h a n
isiphande	i s i p_h a n d E
isiphi	i s i p_h i
isiphila	i s i p_h i l a
isipila	i s i p_> i l a
isiqunto	i s i !_b u n t_> O
isitatestik	i s i t_> a t_> E s t_> i k
isitatestiki	i s i t_> a t_> E s t_> i k i
isitatimende	i s i t_> a t_> i m E n d E
isithombe	i s i t_h O m b E
isithomo	i s i t_h O m O
isitjhebo	i s i tS_h E b_< O
isivumelwano	i s i v u m E l w a n O
isizi	i s i z i
isndebe	i s n d E b_< E
isokana	i s O k a n a
isumi	i s u m i
iteksi	i t_> E k s i
ithi	i t_h i
iti	i t_> i
itiye	i t_> i j E
itjhejwe	i tS_h E d_0Z w E
itjho	i tS_h O
itjhu	i tS_h u
itjhudu	i tS_h u d u
itjhugulu	i tS_h u g u l u
itjhuguluko	i tS_h u g u l u k O
itjhumi	i tS_h u m i
ivele	i v E l E
ivikeleke	i v i k E l E k E
ivikelwe	i v i k E l w E
ivunulo	i v u n u l O
iwahle	i w a K E
iwe	i w E
iwele	i w E l E
iya	i j a
iyalala	i j a l a l a
iyamudla	i j a m u K_b a
iyaphela	i j a p_h E l a
iyay	i j a j
iye	i j E
iyimbeleko	i j i m b E l E k O
iyokuphela	i j O k u p_h E l a
iyokuthengisw	i j O k u t_h E N g i s w
iyokuthengiswa	i j O k u t_h E N g i s w a
iza	i z a
izaga	i z a g a
izakhamuzi	i z a k_h a m u z i
izama	i z a m a
izangiqatha	i z a N g i !_b a t_h a
izangiqotha	i z a N g i !_b O t_h a
izehlakalo	i z E K a k a l O
izele	i z E l E
izenzukuthi	i z E n z u k u t_h i
izi	i z i
izibulo	i z i b_< u l O
izigatjana	i z i g a tS_> a n a
izikutholakala	i z i k u t_h O l a k a l a
izimv	i z i m v
izimvu	i z i m v u
izindaba	i z i n d a b_< a
izinja	i z i n d_0Z a
izinto	i z i n t_> O
iziso	i z i s O
izitjho	i z i tS_h O
izoku	i z O k u
izokutholakala	i z O k u t_h O l a k a l a
izolo	i z O l O
izolokha	i z O l O k_h a
izuba	i z u b_< a
izulu	i z u l u
izuma	i z u m a
j	d_0Z
jama	d_0Z a m a
janson	d_0Z a n s O n
jayelekile	d_0Z a j E l E k i l E
jeepies	d_0Z E p_> i E s
jika	d_0Z i k a
joburg	d_0Z O b_< u r g
johannesburg	d_0Z O a n n E s b_< u r g
julayi	d_0Z u l a j i
k	k
ka	k a
kaba	k a b_< a
kababa	k a b_< a b_< a
kabela	k a b_< E l a
kabuhlungwana	k a b_< u K u N g w a n a
kadladla	k a K_b a K_b a
kagi	k a g i
kagiji	k a g i d_0Z i
kagot	k a g O t_h
kagotjiwe	k a g O tS_> i w E
kakhukhulamungu	k a k_h u k_h u l a m u N g u
kakumalanga	k a k u m a l a N g a
kam	k a m
kamasango	k a m a s a N g O
kamave	k a m a v E
kamavela	k a m a v E l a
kameel	k a m E l
kameelrivier	k a m E l r i v i E r
kamel	k a m E l
kamgwengweni	k a m g w E N g w E n i
kamhlolanja	k a m K O l a n d_0Z a
kamngwengweni	k a m N g w E N g w E n i
kamogotjiwe	k a m O g O tS_> i w E
kamphaka	k a m p_h a k a
kamphakat	k a m p_h a k a t_h
kamqoli	k a m !_b O l i
kamrhayili	k a m x a j i l i
kamtshweni	k a m ts_h w E n i
kamufi	k a m u f i
kamvenselwa	k a m v E n s E l w a
kamxoli	k a m x O l i
kan	k a n
kanamtshweni	k a n a m ts_h w E n i
kancani	k a n |_b a n i
kancaza	k a n |_b a z a
kancazana	k a n |_b a z a n a
kanga	k a N g a
kangaka	k a N g a k a
kangan	k a N g a n
kangangani	k a N g a N g a n i
kanobayeni	k a n O b_< a j E n i
kanqaza	k a n !_b a z a
kanqazan	k a n !_b a z a n
kanta	k a n t_> a
kantaka	k a n t_> a k a
kanti	k a n t_> i
kany	k a J
kanye	k a J E
kaqoli	k a !_b O l i
karhoboyi	k a x O b_< O j i
kasihlabantangana	k a s i K a b_< a n t_> a N g a n a
kasinyikhaba	k a s i J i k_h a b_< a
kaskhosa	k a s k_h O s a
kaskhosana	k a s k_h O s a n a
kathathu	k a t_h a t_h u
kathobi	k a t_h O b_< i
kathobile	k a t_h O b_< i l E
katjhirhweni	k a tS_h i x w E n i
kavela	k a v E l a
kavelabahlinze	k a v E l a b_< a K i n z E
kaxoli	k a x O l i
kazi	k a z i
ke	k E
keba	k E b_< a
kebakayise	k E b_< a k a j i s E
kelinye	k E l i J E
kemptonpark	k E m p_h t_> O n p_> a r k
kethlanga	k E t_h K a N g a
kghani	kx a n i
kghona	kx O n a
kha	k_h a
khala	k_h a l a
khamba	k_h a m b a
khange	k_h a N g E
khawa	k_h a w a
khawatjele	k_h a w a tS_> E l E
khawatjhele	k_h a w a tS_h E l E
khawe	k_h a w E
khawen	k_h a w E n
khawule	k_h a w u l E
khaya	k_h a j a
khebajame	k_h E b_< a d_0Z a m E
khebay	k_h E b_< a j
khebayili	k_h E b_< a j i l i
khebayilinde	k_h E b_< a j i l i n d E
khebayilindele	k_h E b_< a j i l i n d E l E
khebayilindile	k_h E b_< a j i l i n d i l E
khebayo	k_h E b_< a j O
kheku	k_h E k u
khekuphele	k_h E k_> u p_h E l E
khenge	k_h E N g E
kherige	k_h E r i g E
kheu	k_h E u
khewutjele	k_h E w u tS_> E l E
khezila	k_h E z i l a
khezilayitjhwe	k_h E z i l a j i tS_h w E
kheziyal	k_h E z i j a l
khipha	k_h i p_h a
kho	k_h O
khomba	k_h O m b a
khon	k_h O n
khona	k_h O n a
khonapho	k_h O n a p_h O
khu	k_h u
khube	k_h u b_< E
khudlwana	k_h u K_b w a n a
khukhulamungu	k_h u k_h u l a m u N g u
khulamungu	k_h u l a m u N g u
khulu	k_h u l u
khulukhulu	k_h u l u k_h u l u
khuluma	k_h u l u m a
khunye	k_h u J E
ki	k i
kile	k i l E
kileli	k i l E l i
kilelo	k i l E l O
kilelolifa	k i l E l O l i f a
kileyo	k i l E j O
kileyondinyana	k i l E j O n d i J a n a
kilo	k i l O
kiyo	k i j O
kizo	k i z O
ko	k O
koba	k O b_< a
kobana	k O b_< a n a
kobanyana	k O b_< a J a n a
kodwa	k O d w a
kodwana	k O d w a n a
koke	k O k E
kokhunye	k O k_h u J E
koko	k O k O
kokobana	k O k O b_< a n a
koku	k O k u
kokuba	k O k u b_< a
kokubana	k O k u b_< a n a
kokumo	k O k u m O
kokumotjha	k O k u m O tS_h a
kokumu	k O k u m u
kokunganisana	k O k u N g a n i s a n a
kokuthi	k O k u t_h i
kokuthoma	k O k u t_h O m a
kokuyaphi	k O k u j a p_h i
kokwanda	k O k w a n d a
komati	k O m a t_> i
kombuso	k O m b u s O
komezo	k O m E z O
komphakathi	k O m p_h a k a t_h i
komthetho	k O m t_h E t_h O
komthethosisekelo	k O m t_h E t_h O s i s E k E l O
komuthi	k O m u t_h i
konakele	k O n a k E l E
kormkrans	k O r m k r a n s
kromdraai	k r O m d r a a i
kromkrans	k r O m k r a n s
kroomkrans	k r O O m k r a n s
ku	k u
kuba	k u b_< a
kubaba	k u b_< a b_< a
kubasiwe	k u b_< a s i w E
kubaswe	k u b_< a s w E
kubayeni	k u b_< a j E n i
kubayini	k u b_< a j i n i
kube	k u b_< E
kubeke	k u b_< E k E
kubethe	k u b_< E t_h E
kubethile	k u b_< E t_h i l E
kubi	k u b_< i
kubili	k u b_< i l i
kubona	k u b_< O n a
kubonakala	k u b_< O n a k a l a
kubonakale	k u b_< O n a k a l E
kubovu	k u b_< O v u
kubuli	k u b_< u l i
kubunane	k u b_< u n a n E
kubuyelwe	k u b_< u j E l w E
kude	k u d E
kudinwa	k u d i n w a
kuf	k u f
kufana	k u f a n a
kufanele	k u f a n E l E
kufe	k u f E
kufi	k u f i
kufuze	k u f u z E
kufuzeke	k u f u z E k E
kufuzile	k u f u z i l E
kuh	k u
kuhambelana	k u a m b E l a n a
kuhlalwe	k u K a l w E
kuhlangan	k u K a N g a n
kuhlanganisa	k u K a N g a n i s a
kuhlanu	k u K a n u
kuhle	k u K E
kuhleziphi	k u K E z i p_h i
kuhlo	k u K O
kuhloko	k u K O k O
kuhlokokulu	k u K O k O k u l u
kujame	k u d_0Z a m E
kujimsoni	k u d_0Z i m s O n i
kuka	k u k a
kukahleziphi	k u k a K E z i p_h i
kukghona	k u kx O n a
kukha	k u k_h a
kukhamba	k u k_h a m b a
kukhambelana	k u k_h a m b E l a n a
kukhomba	k u k_h O m b a
kukhona	k u k_h O n a
kukhu	k u k_h u
kukhuk	k u k_h u k
kukhukhu	k u k_h u k_h u
kukhukhula	k u k_h u k_h u l a
kukhukhulamungu	k u k_h u k_h u l a m u N g u
kukhukhumba	k u k_h u k_h u m b a
kukhulu	k u k_h u l u
kukhulunywa	k u k_h u l u J w a
kuko	k u k O
kukobana	k u k O b_< a n a
kukobanyana	k u k O b_< a J a n a
kukube	k u k u b_< E
kukulahlekelwa	k u k u l a K E k E l w a
kukulungwana	k u k u l u N g w a n a
kukunye	k u k u J E
kukuseni	k u k u s E n i
kukuthi	k u k u t_h i
kukwini	k u k w i n i
kulahlekelwa	k u l a K E k E l w a
kulikhom	k u l i k_h O m
kulikhomba	k u l i k_h O m b a
kulinywa	k u l i J w a
kuliqiniso	k u l i !_b i n i s O
kulu	k u l u
kulungwana	k u l u N g w a n a
kulungwane	k u l u N g w a n E
kulwana	k u l w a n a
kum	k u m
kuma	k u m a
kumalila	k u m a l i l a
kumalile	k u m a l i l E
kumaliledini	k u m a l i l E d i n i
kumaliledinin	k u m a l i l E d i n i n
kumaliledinini	k u m a l i l E d i n i n i
kumashishini	k u m a s i s i n i
kumasumi	k u m a s u m i
kumatjhumi	k u m a tS_h u m i
kumbi	k u m b i
kumgwengweni	k u m g w E N g w E n i
kumh	k u m
kumhla	k u m K a
kumhlolanj	k u m K O l a n d_0Z
kumhlolanja	k u m K O l a n d_0Z a
kumhlolonja	k u m K O l O n d_0Z a
kuminyaka	k u m i J a k a
kumnyango	k u m J a N g O
kumongameli	k u m O N g a m E l i
kumphendula	k u m p_h E n d u l a
kumporofi	k u m p_> O r O f i
kumrhayili	k u m x a j i l i
kumthuse	k u m t_h u s E
kun	k u n
kuna	k u n a
kunana	k u n a n a
kunane	k u n a n E
kuncono	k u n |_b O n O
kune	k u n E
kuneenkomo	k u n E N k O m O
kunenkomo	k u n E N k_> O m O
kunezibuko	k u n E z i b_< u k O
kunezibulo	k u n E z i b_< u l O
kunezibuz	k u n E z i b_< u z
kunga	k u N g a
kungaba	k u N g a b_< a
kungakhambisana	k u N g a k_h a m b i s a n a
kungakho	k u N g a k_h O
kungasaveli	k u N g a s a v E l i
kungatjho	k u N g a tS_h O
kungavukwa	k u N g a v u k w a
kungavulw	k u N g a v u l w
kunghala	k u N a l a
kungujimsoni	k u N g u d_0Z i m s O n i
kunjani	k u n d_0Z a n i
kuno	k u n O
kunobaye	k u n O b_< a j E
kunobayeni	k u n O b_< a j E n i
kunoma	k u n O m a
kunomuda	k u n O m u d a
kunomzana	k u n O m z a n a
kunqotjhisiwe	k u n !_b O tS_h i s i w E
kunqotjhiswe	k u n !_b O tS_h i s w E
kunta	k u n t_> a
kuntak	k u n t_> a k
kuntaka	k u n t_> a k a
kuntathu	k u n t_> a t_h u
kunu	k u n u
kunye	k u J E
kunzima	k u n z i m a
kuphe	k u p_h E
kuphendula	k u p_h E n d u l a
kuphi	k u p_h i
kuqanda	k u !_b a n d a
kuqot	k u !_b O t_h
kurha	k u x a
kurhala	k u x a l a
kurhayil	k u x a j i l
kurhayila	k u x a j i l a
kurhoboyi	k u x O b_< O j i
kus	k u s
kusaba	k u s a b_< a
kusarara	k u s a r a r a
kusasa	k u s a s a
kusebenza	k u s E b_< E n z a
kusekuseni	k u s E k_> u s E n i
kusemahlombe	k u s E m a K O m b E
kusemu	k u s E m u
kusewula	k u s E w u l a
kusezamokuhle	k u s E z a m O k u K E
kusi	k u s i
kusihlaba	k u s i K a b_< a
kusihlabantangana	k u s i K a b_< a n t_> a N g a n a
kusihlana	k u s i K a n a
kusinya	k u s i J a
kusinyikha	k u s i J i k_h a
kusinyikhab	k u s i J i k_h a b_<
kusinyikhaba	k u s i J i k_h a b_< a
kusithandathu	k u s i t_h a n d a t_h u
kusize	k u s i z E
kuskhosana	k u s k_h O s a n a
kuskhu	k u s k_h u
kusu	k u s u
kusukela	k u s u k E l a
kuthandath	k u t_h a n d a t_h
kuthandathu	k u t_h a n d a t_h u
kuthandaz	k u t_h a n d a z
kuthandazwe	k u t_h a n d a z w E
kuthandeka	k u t_h a n d E k a
kuthathu	k u t_h a t_h u
kuthe	k u t_h E
kuthi	k u t_h i
kuthini	k u t_h i n i
kuthiwa	k u t_h i w a
kuthoba	k u t_h O b_< a
kutholwe	k u t_h O l w E
kuthome	k u t_h O m E
kutjengisa	k u tS_> E N g i s a
kutjhirhwe	k u tS_h i x w E
kutjhirhweni	k u tS_h i x w E n i
kutjho	k u tS_h O
kutjhugulukela	k u tS_h u g u l u k E l a
kuve	k u v E
kuvela	k u v E l a
kuvelabahlinze	k u v E l a b_< a K i n z E
kuveza	k u v E z a
kuvu	k u v u
kuvusi	k u v u s i
kuy	k u j
kuyaqaqamba	k u j a !_b a !_b a m b a
kuyatjho	k u j a tS_h O
kuye	k u j E
kuyu	k u j u
kuza	k u z a
kuzaba	k u z a b_< a
kuzabe	k u z a b_< E
kuzwa	k u z w a
kuzwakale	k u z w a k a l E
kwa	k w a
kwaba	k w a b_< a
kwabakhona	k w a b_< a k_h O n a
kwabamhlo	k w a b_< a m K O
kwabamhlophe	k w a b_< a m K O p_h E
kwabanakubili	k w a b_< a n a k u b_< i l i
kwabane	k w a b_< a n E
kwabanele	k w a b_< a n E l E
kwabano	k w a b_< a n O
kwabanomuda	k w a b_< a n O m u d a
kwabanongqi	k w a b_< a n O N !_bg i
kwabe	k w a b_< E
kwabong	k w a b_< O N g
kwabongwe	k w a b_< O N g w E
kwadlawulale	k w a K_b a w u l a l E
kwadliwa	k w a K_b i w a
kwaggafontein	k w a g g a f O n t_> E i n
kwak	k w a k
kwaka	k w a k a
kwakamasilela	k w a k a m a s i l E l a
kwakanamasilela	k w a k a n a m a s i l E l a
kwakhe	k w a k_h E
kwakho	k w a k_h O
kwakhona	k w a k_h O n a
kwalokho	k w a l O k_h O
kwalungiselwa	k w a l u N g i s E l w a
kwalungiswa	k w a l u N g i s w a
kwam	k w a m
kwama	k w a m a
kwamadin	k w a m a d i n
kwamadina	k w a m a d i n a
kwamadlayi	k w a m a K_b a j i
kwamagobh	k w a m a g O b
kwamagobho	k w a m a g O b O
kwamaku	k w a m a k u
kwamamba	k w a m a m b a
kwamambala	k w a m a m b a l a
kwamanikelela	k w a m a n i k E l E l a
kwamapholisa	k w a m a p_h O l i s a
kwamaqongo	k w a m a !_b O N g O
kwamasumi	k w a m a s u m i
kwamaswahla	k w a m a s w a K a
kwamatjhumi	k w a m a tS_h u m i
kwamazindla	k w a m a z i n K_b a
kwamgidi	k w a m g i d i
kwamhla	k w a m K a
kwamhlan	k w a m K a n
kwamhlanga	k w a m K a N g a
kwami	k w a m i
kwamnguni	k w a m N g u n i
kwamzawakhe	k w a m z a w a k_h E
kwande	k w a n d E
kwandebe	k w a n d E b_< E
kwandebele	k w a n d E b_< E l E
kwanikene	k w a n i k E n E
kwanjes	k w a n d_0Z E s
kwanqoth	k w a n !_b O t_h
kwanqothuka	k w a n !_b O t_h u k a
kwanquthuka	k w a n !_b u t_h u k a
kwaphahla	k w a p_h a K a
kwaphela	k w a p_h E l a
kwaskhosana	k w a s k_h O s a n a
kwatj	k w a tS_h
kwatjhiwo	k w a tS_h i w O
kwatutu	k w a t_> u t_> u
kwawo	k w a w O
kwayo	k w a j O
kwazala	k w a z a l a
kwaziwa	k w a z i w a
kwazo	k w a z O
kwe	k w E
kwebhesi	k w E b E s i
kweempepha	k w E m p_> E p_h a
kweemvumelwano	k w E m v u m E l w a n O
kweenlori	k w E n l O r i
kwehliziyo	k w E K i z i j O
kwelori	k w E l O r i
kwemi	k w E m i
kwen	k w E n
kwengqondo	k w E N !_bg O n d O
kwenhliziyo	k w E n K i z i j O
kwenlo	k w E n l O
kwenqo	k w E n !_b O
kwenqon	k w E n !_b O n
kwenqond	k w E n !_b O n d
kwenqondo	k w E n !_b O n d O
kwente	k w E n t_> E
kwentela	k w E n t_> E l a
kwenya	k w E J a
kwenza	k w E n z a
kwenzanja	k w E n z a n d_0Z a
kwenzanjani	k w E n z a n d_0Z a n i
kwenze	k w E n z E
kwenzekile	k w E n z E k i l E
kwepitori	k w E p_> i t_> O r i
kwesikhathi	k w E s i k_h a t_h i
kwetafula	k w E t_> a f u l a
kwetjheduli	k w E tS_h E d u l i
kwetjiwa	k w E tS_> i w a
kwevu	k w E v u
kwevulamlomo	k w E v u l a m l O m O
kwevum	k w E v u m
kwevumelwano	k w E v u m E l w a n O
kweyama	k w E j a m a
kwezindlu	k w E z i n K_b u
kwezinye	k w E z i J E
kwezoku	k w E z O k u
kwezokuhlalisana	k w E z O k u K a l i s a n a
kwezokuphatha	k w E z O k u p_h a t_h a
kwezomphakathi	k w E z O m p_h a k a t_h i
l	l
la	l a
laba	l a b_< a
labo	l a b_< O
lady	l a d j
lakaba	l a k_> a b_< a
lakababa	l a k_> a b_< a b_< a
lakamavela	l a k_> a m a v E l a
lakhe	l a k_h E
lakhona	l a k_h O n a
lakwa	l a k w a
lakwandebele	l a k w a n d E b_< E l E
lalapha	l a l a p_h a
lam	l a m
lama	l a m a
lamabeletho	l a m a b_< E l E t_h O
lamabizo	l a m a b_< i z O
lamasumi	l a m a s u m i
lamatjhumi	l a m a tS_h u m i
lamawese	l a m a w E s E
lamaweseli	l a m a w E s E l i
lami	l a m i
langa	l a N g a
lange	l a N g E
langekos	l a N g E k O s
langekosini	l a N g E k O s i n i
langepitori	l a N g E p_> i t_> O r i
langesiyabus	l a N g E s i j a b_< u s
langesiyabuswa	l a N g E s i j a b_< u s w a
laph	l a p_h
lapha	l a p_h a
lapho	l a p_h O
lasesiyabuswa	l a s E s i j a b_< u s w a
lawa	l a w a
lawakghuthula	l a w a kx u t_h u l a
lawukghuthula	l a w u kx u t_h u l a
layele	l a j E l E
layelisa	l a j E l i s a
layo	l a j O
laziwa	l a z i w a
le	l E
leather	l E a t_h E r
lebhetali	l E b E t_> a l i
leembiliga	l E m b i l i g a
leembilinga	l E m b i l i N g a
leemfunda	l E m f u n d a
leemfundo	l E m f u n d O
leempande	l E m p_> a n d E
leenkomezo	l E N k_> O m E z O
lekhomba	l E k_h O m b a
lekhulu	l E k_h u l u
leli	l E l i
lelibadi	l E l i b_< a d i
lelibhadi	l E l i b a d i
lelimi	l E l i m i
lelimu	l E l i m u
lelize	l E l i z E
lelizwe	l E l i z w E
lelizweloke	l E l i z w E l O k E
lelo	l E l O
lemb	l E m b
lembiliga	l E m b i l i g a
lemi	l E m i
lemiphumela	l E m i p_h u m E l a
len	l E n
lenaspoti	l E n a s p_> O t_> i
lendaba	l E n d a b_< a
lendawo	l E n d a w O
lento	l E n t_> O
lepitor	l E p_> i t_> O r
leqela	l E !_b E l a
les	l E s
lesewula	l E s E w u l a
lesi	l E s i
lesibi	l E s i b_< i
lesibil	l E s i b_< i l
lesibili	l E s i b_< i l i
lesihlanu	l E s i K a n u
lesikhombi	l E s i k_h O m b i
lesikhombis	l E s i k_h O m b i s
lesikhombisa	l E s i k_h O m b i s a
lesindebele	l E s i n d E b_< E l E
lesine	l E s i n E
lesipholisa	l E s i p_h O l i s a
lesisibawo	l E s i s i b_< a w O
lesitha	l E s i t_h a
lesithand	l E s i t_h a n d
lesithanda	l E s i t_h a n d a
lesithandath	l E s i t_h a n d a t_h
lesithandathu	l E s i t_h a n d a t_h u
lesithath	l E s i t_h a t_h
lesithathu	l E s i t_h a t_h u
lesiyabuswa	l E s i j a b_< u s w a
lesizweloke	l E s i z w E l O k E
lesko	l E s k O
leso	l E s O
lesumi	l E s u m i
letho	l E t_h O
lethoba	l E t_h O b_< a
letjh	l E tS_h
letjhumi	l E tS_h u m i
lex	l E x
lexical	l E x i |_b a l
leyo	l E j O
lez	l E z
leza	l E z a
leze	l E z E
lezefihlo	l E z E f i K O
lezemfundo	l E z E m f u n d O
lezi	l E z i
lezokwamukelwa	l E z O k w a m u k E l w a
li	l i
libe	l i b_< E
libun	l i b_< u n
licatjhaza	l i |_b a tS_h a z a
lidla	l i K_b a
lidoswa	l i d O s w a
lifa	l i f a
lifikile	l i f i k i l E
lihlangana	l i K a N g a n a
lihlangane	l i K a N g a n E
lika	l i k a
likagogo	l i k a g O g O
likaku	l i k a k u
likamavela	l i k a m a v E l a
likamufi	l i k a m u f i
likan	l i k a n
likanamkoneni	l i k a n a m k O n E n i
likanom	l i k a n O m
likh	l i k_h
likhom	l i k_h O m
likhomba	l i k_h O m b a
likhulu	l i k_h u l u
likhululu	l i k_h u l u l u
likuhlabe	l i k u K a b_< E
likuthoma	l i k u t_h O m a
lilanga	l i l a N g a
lilila	l i l i l a
lilinye	l i l i J E
lilize	l i l i z E
lilokha	l i l O k_h a
limalanga	l i m a l a N g a
limhla	l i m K a
limhlana	l i m K a n a
limhlazana	l i m K a z a n a
limi	l i m i
limkhahlameza	l i m k_h a K a m E z a
lin	l i n
linane	l i n a n E
line	l i n E
lingakhula	l i N g a k_h u l a
lingaku	l i N g a k u
lingamatjhumi	l i N g a m a tS_h u m i
lingentjh	l i N g E n tS_h
lingetjhumi	l i N g E tS_h u m i
lingezwa	l i N g E z w a
lingomhla	l i N g O m K a
lingomhlaka	l i N g O m K a k a
lingomhlazana	l i N g O m K a z a n a
lingonyaka	l i N g O J a k a
lingumhla	l i N g u m K a
lingumhlawamasumi	l i N g u m K a w a m a s u m i
linye	l i J E
liqanda	l i !_b a n d a
liqaqhazi	l i !_b a !_bh a z i
liqathaza	l i !_b a t_h a z a
liqatjhaz	l i !_b a tS_h a z
liqatjhaza	l i !_b a tS_h a z a
liqatjhazana	l i !_b a tS_h a z a n a
liqatjhazi	l i !_b a tS_h a z i
liqatjhazo	l i !_b a tS_h a z O
liqhatjhaza	l i !_bh a tS_h a z a
liqhatjhazi	l i !_bh a tS_h a z i
lirhurhule	l i x u x u l E
lis	l i s
lisahle	l i s a K E
lisahlele	l i s a K E l E
lisahlezi	l i s a K E z i
lisaqinile	l i s a !_b i n i l E
lise	l i s E
lisebenza	l i s E b_< E n z a
lisehlele	l i s E K E l E
lisela	l i s E l a
liselangeni	l i s E l a N g E n i
lisemalangeni	l i s E m a l a N g E n i
lisihlanu	l i s i K a n u
lisikhala	l i s i k_h a l a
lisumi	l i s u m i
lit	l i t_h
lithe	l i t_h E
lithi	l i t_h i
litho	l i t_h O
lithob	l i t_h O b_<
lithoba	l i t_h O b_< a
litjhada	l i tS_h a d a
litjhu	l i tS_h u
litjhumi	l i tS_h u m i
litjhumina	l i tS_h u m i n a
litlolwe	l i tK_> O l w E
livalo	l i v a l O
liyeza	l i j E z a
liyishumi	l i j i s u m i
liza	l i z a
lizakwizwa	l i z a k w i z w a
lize	l i z E
lizokuzwisisa	l i z O k u z w i s i s a
lizwiwa	l i z w i w a
lo	l O
lobuhlakaniphi	l O b_< u K a k a n i p_h i
lobuhlanu	l O b_< u K a n u
lobunane	l O b_< u n a n E
lobunani	l O b_< u n a n i
loke	l O k E
lokha	l O k_h a
lokho	l O k_h O
lokhu	l O k_h u
lokihlam	l O k i K a m
lokuhlakanipha	l O k u K a k a n i p_h a
lokuhlambela	l O k u K a m b E l a
lokuhlange	l O k u K a N g E
lokutha	l O k u t_h a
lokutho	l O k u t_h O
lokuthola	l O k u t_h O l a
lokuthom	l O k u t_h O m
lokuthoma	l O k u t_h O m a
lokuthomba	l O k u t_h O m b a
lomdumo	l O m d u m O
lomli	l O m l i
lomlilo	l O m l i l O
lomraro	l O m r a r O
lomsanyana	l O m s a J a n a
lona	l O n a
london	l O n d O n
lonke	l O N k E
lowo	l O w O
loya	l O j a
loyo	l O j O
lukuluku	l u k u l u k u
lungiswa	l u N g i s w a
luth	l u t_h
lydenburg	l j d E n b_< u r g
m	m
ma	m a
mabili	m a b_< i l i
machadodorp	m a |_bh a d O d O r p_h
madala	m a d a l a
madod	m a d O d
madoda	m a d O d a
mahlazana	m a K a z a n a
mahlombe	m a K O m b E
majthumi	m a d_0Z t_h u m i
makalisumi	m a k a l i s u m i
makeso	m a k E s O
makhe	m a k_h E
makhulu	m a k_h u l u
mako	m a k O
mal	m a l
malanga	m a l a N g a
malile	m a l i l E
maliledinini	m a l i l E d i n i n i
malilinye	m a l i l i J E
malini	m a l i n i
malunga	m a l u N g a
malungana	m a l u N g a n a
manje	m a n d_0Z E
manjes	m a n d_0Z E s
marapyane	m a r a p_h j a n E
marble	m a r b_< l E
marete	m a r E t_> E
maseko	m a s E k O
masu	m a s u
masuma	m a s u m a
masumi	m a s u m i
mathathu	m a t_h a t_h u
mathjumi	m a t_h d_0Z u m i
matjhila	m a tS_h i l a
matjhuma	m a tS_h u m a
matjhumi	m a tS_h u m i
matyzensloop	m a t_h j z E n s l O O p_h
mavela	m a v E l a
maye	m a j E
mayelana	m a j E l a n a
mazi	m a z i
mazibuse	m a z i b_< u s E
mba	m b a
mbadlwana	m b a K_b w a n a
mbala	m b a l a
mbili	m b i l i
mcaba	m |_b a b_< a
mcaban	m |_b a b_< a n
mcabango	m |_b a b_< a N g O
mdana	m d a n a
mdum	m d u m
mdumo	m d u m O
me	m E
mean	m E a n
mehlo	m E K O
merwel	m E r w E l
mhl	m K
mhla	m K a
mhlaka	m K a k a
mhlaku	m K a k u
mhlakungujimsoni	m K a k u N g u d_0Z i m s O n i
mhlalesumi	m K a l E s u m i
mhlana	m K a n a
mhlanokho	m K a n O k_h O
mhlanya	m K a J a
mhlanzana	m K a n z a n a
mhlawa	m K a w a
mhlawula	m K a w u l a
mhlawulani	m K a w u l a n i
mhlawulwana	m K a w u l w a n a
mhlazana	m K a z a n a
mhlazimasumi	m K a z i m a s u m i
mhlazintandathu	m K a z i n t_> a n d a t_h u
middelbu	m i d d E l b_< u
middelburg	m i d d E l b_< u r g
midran	m i d r a n
midrand	m i d r a n d
mileko	m i l E k O
mimithikazi	m i m i t_h i k a z i
mina	m i n a
minyaka	m i J a k a
mitlolo	m i tK_> O l O
mizu	m i z u
mizuzu	m i z u z u
mkhozi	m k_h O z i
mkhu	m k_h u
mkhulu	m k_h u l u
mngwengweni	m N g w E N g w E n i
mntaza	m n t_> a z a
mntazana	m n t_> a z a n a
mntwa	m n t_> w a
mntwana	m n t_> w a n a
mntwe	m n t_> w E
mnyaka	m J a k a
mnyakema	m J a k E m a
mnyosi	m J O s i
motsu	m O ts_> u
mpa	m p_> a
mpumalang	m p_> u m a l a N g
mpumalanga	m p_> u m a l a N g a
mqabang	m !_b a b_< a N g
mqabango	m !_b a b_< a N g O
mra	m r a
mrarululi	m r a r u l u l i
mrhwamu	m x w a m u
msinya	m s i J a
msinyana	m s i J a n a
msinyani	m s i J a n i
mswekhethu	m s w E k_h E t_h u
mta	m t_> a
mtato	m t_> a t_> O
mtatweni	m t_> a t_> w E n i
mthadlana	m t_h a K_b a n a
mthala	m t_h a l a
mthambothi	m t_h a m b O t_h i
mtjhana	m tS_h a n a
mumuda	m u m u d a
mumuntu	m u m u n t_> u
mun	m u n
munda	m u n d a
mung	m u N g
muntu	m u n t_> u
munye	m u J E
muphi	m u p_h i
muqa	m u !_b a
musa	m u s a
mzimba	m z i m b a
mzu	m z u
mzukwana	m z u k w a n a
n	n
na	n a
naa	n a a
naba	n a b_< a
nabafu	n a b_< a f u
nabafuna	n a b_< a f u n a
nabanakubili	n a b_< a n a k u b_< i l i
nabang	n a b_< a N g
nabangamazi	n a b_< a N g a m a z i
nabangamaziko	n a b_< a N g a m a z i k O
nabangaziko	n a b_< a N g a z i k O
nabantu	n a b_< a n t_> u
nabantwana	n a b_< a n t_> w a n a
nabemizi	n a b_< E m i z i
nabemizini	n a b_< E m i z i n i
nabenzi	n a b_< E n z i
nabesana	n a b_< E s a n a
nabisa	n a b_< i s a
nabo	n a b_< O
nabobamkhulu	n a b_< O b_< a m k_h u l u
nabomkhulu	n a b_< O m k_h u l u
nabomma	n a b_< O m m a
nabomrharibakhe	n a b_< O m x a r i b_< a k_h E
nabovu	n a b_< O v u
nabu	n a b_< u
nabunane	n a b_< u n a n E
nafana	n a f a n a
nahl	n a K
nahlani	n a K a n i
nahlanu	n a K a n u
nai	n a i
nak	n a k
naka	n a k a
nakabona	n a k a b_< O n a
nakacoca	n a k a |_b O |_b a
nakafika	n a k a f i k a
nakalisumi	n a k a l i s u m i
nakalitjhumi	n a k a l i tS_h u m i
nakamabili	n a k a m a b_< i l i
nakamathathu	n a k a m a t_h a t_h u
nakamatjhu	n a k a m a tS_h u
nakangenako	n a k a N g E n a k O
nakanjalo	n a k a n d_0Z a l O
nakanje	n a k a n d_0Z E
nakanjena	n a k a n d_0Z E n a
nakasithathu	n a k a s i t_h a t_h u
nakathi	n a k a t_h i
nakezwa	n a k E z w a
nakhom	n a k_h O m
nakhomba	n a k_h O m b a
nakhombisa	n a k_h O m b i s a
nakhu	n a k_h u
nakikhu	n a k i k_h u
nakithi	n a k i t_h i
nako	n a k O
naku	n a k u
nakube	n a k u b_< E
nakubili	n a k u b_< i l i
nakuhl	n a k u K
nakuhla	n a k u K a
nakuhlanu	n a k u K a n u
nakuhle	n a k u K E
nakukhambe	n a k u k_h a m b E
nakukhiwa	n a k u k_h i w a
nakukhomba	n a k u k_h O m b a
nakuku	n a k u k u
nakukube	n a k u k u b_< E
nakumalanga	n a k u m a l a N g a
nakunane	n a k u n a n E
nakundrathu	n a k u n d r a t_h u
nakune	n a k u n E
nakungewekulungwana	n a k u N g E w E k_> u l u N g w a n a
nakunye	n a k u J E
nakuskho	n a k u s k_h O
nakuskhosana	n a k u s k_h O s a n a
nakuyinja	n a k u j i n d_0Z a
nakuyokulayitjhwa	n a k u j O k u l a j i tS_h w a
nakwana	n a k w a n a
nakwezinye	n a k w E z i J E
nalaphaya	n a l a p_h a j a
nalapho	n a l a p_h O
nali	n a l i
nalikhulako	n a l i k_h u l a k O
nalinye	n a l i J E
naliphakamako	n a l i p_h a k a m a k O
naliphumako	n a l i p_h u m a k O
nalithi	n a l i t_h i
nalitjhumi	n a l i tS_h u m i
naliya	n a l i j a
nalo	n a l O
nalom	n a l O m
nalomhlobo	n a l O m K O b_< O
nalomhlolo	n a l O m K O l O
nam	n a m
nama	n a m a
namabhodlelo	n a m a b O K_b E l O
namabi	n a m a b_< i
namabili	n a m a b_< i l i
namabubulo	n a m a b_< u b_< u l O
namabululo	n a m a b_< u l u l O
namahlanu	n a m a K a n u
namahlathi	n a m a K a t_h i
namahlaya	n a m a K a j a
namakhaya	n a m a k_h a j a
namakhulu	n a m a k_h u l u
namakhuluku	n a m a k_h u l u k u
namal	n a m a l
namalanga	n a m a l a N g a
namandla	n a m a n K_b a
namas	n a m a s
namaseka	n a m a s E k a
namasenkana	n a m a s E N k_> a n a
namasiko	n a m a s i k O
namasilela	n a m a s i l E l a
namasumi	n a m a s u m i
namathathu	n a m a t_h a t_h u
namatjhumama	n a m a tS_h u m a m a
namatjhumi	n a m a tS_h u m i
namatorhwana	n a m a t_> O x w a n a
namatorhwanami	n a m a t_> O x w a n a m i
nambil	n a m b i l
nambili	n a m b i l i
namezwi	n a m E z w i
namhlanje	n a m K a n d_0Z E
namhlanjesi	n a m K a n d_0Z E s i
nami	n a m i
namibili	n a m i b_< i l i
namithathu	n a m i t_h a t_h u
namkha	n a m k_h a
namkhu	n a m k_h u
namkhukulahlekelwa	n a m k_h u k u l a K E k E l w a
namkhulu	n a m k_h u l u
namkhun	n a m k_h u n
namkoneni	n a m k O n E n i
namtshweni	n a m ts_h w E n i
namunye	n a m u J E
namzwezi	n a m z w E z i
nan	n a n
nane	n a n E
nang	n a N g
nangaba	n a N g a b_< a
nangabe	n a N g a b_< E
nangabukufa	n a N g a b_< u k u f a
nangambala	n a N g a m b a l a
nangaphasi	n a N g a p_h a s i
nangaphezulu	n a N g a p_h E z u l u
nangazi	n a N g a z i
nange	n a N g E
nangeempumu	n a N g E m p_> u m u
nangeempumulo	n a N g E m p_> u m u l O
nangempumu	n a N g E m p_> u m u
nangisuka	n a N g i s u k a
nangu	n a N g u
nanhlanu	n a n K a n u
nani	n a n i
nanje	n a n d_0Z E
nanta	n a n t_> a
nantandathu	n a n t_> a n d a t_h u
nantathu	n a n t_> a t_h u
nantha	n a n t_h a
nanthathu	n a n t_h a t_h u
nanti	n a n t_> i
nany	n a J
nanyana	n a J a n a
nanye	n a J E
naphambilini	n a p_h a m b i l i n i
nas	n a s
nasakha	n a s a k_h a
nasele	n a s E l E
nasemnya	n a s E m J a
nasi	n a s i
nasikhombisa	n a s i k_h O m b i s a
nasithandath	n a s i t_h a n d a t_h
nasithandathu	n a s i t_h a n d a t_h u
naso	n a s O
nasthandath	n a s t_h a n d a t_h
nathandathu	n a t_h a n d a t_h u
nathathu	n a t_h a t_h u
nathi	n a t_h i
nathoba	n a t_h O b_< a
nathobako	n a t_h O b_< a k O
navane	n a v a n E
nawamatjhumi	n a w a m a tS_h u m i
nawe	n a w E
nawubona	n a w u b_< O n a
nawubonak	n a w u b_< O n a k
nawubonako	n a w u b_< O n a k O
nawus	n a w u s
nawusala	n a w u s a l a
nawuzikhohlisa	n a w u z i k_h O K i s a
nay	n a j
naye	n a j E
nayikulungwana	n a j i k_> u l u N g w a n a
nayinamasumi	n a j i n a m a s u m i
nayinye	n a j i J E
nayiyinye	n a j i j i J E
nayo	n a j O
nazi	n a z i
nazibuya	n a z i b_< u j a
nazine	n a z i n E
nazo	n a z O
ndaba	n d a b_< a
ndebe	n d E b_< E
ndebel	n d E b_< E l
ndebele	n d E b_< E l E
ne	n E
nebha	n E b a
nebhara	n E b a r a
nebhareni	n E b a r E n i
nebonane	n E b_< O n a n E
nebunane	n E b_< u n a n E
nebusweni	n E b_< u s w E n i
nedarada	n E d a r a d a
neempande	n E m p_> a n d E
neendlebe	n E n K_b E b_< E
neenko	n E N k O
neenkomo	n E N k O m O
neenkulungwana	n E N k u l u N g w a n a
neenlwal	n E n l w a l
neenlwalweni	n E n l w a l w E n i
neenlwana	n E n l w a n a
neenlwaneni	n E n l w a n E n i
neenrajelo	n E n r a d_0Z E l O
neenrarejo	n E n r a r E d_0Z O
neenyawo	n E J a w O
nef	n E f
nefane	n E f a n E
nefund	n E f u n d
nefundo	n E f u n d O
nehlathululo	n E K a t_h u l u l O
neka	n E k a
nekabi	n E k a b_< i
nekam	n E k a m
nekamero	n E k a m E r O
nekampa	n E k a m p_> a
nekghuru	n E kx u r u
nekhabo	n E k_h a b_< O
nekhambo	n E k_h a m b O
nekhom	n E k_h O m
nekhomba	n E k_h O m b a
nekhulu	n E k_h u l u
nekus	n E k_> u s
nelanga	n E l a N g a
nelange	n E l a N g E
nelikamfowabo	n E l i k a m f O w a b_< O
nelikasontonga	n E l i k a s O n t_> O N g a
neliska	n E l i s k a
nelit	n E l i t_h
nelize	n E l i z E
nem	n E m
nema	n E m a
nemal	n E m a l
nemali	n E m a l i
nemf	n E m f
nemi	n E m i
nemibandela	n E m i b_< a n d E l a
nemibili	n E m i b_< i l i
neminane	n E m i n a n E
nemini	n E m i n i
neminyaka	n E m i J a k a
nemiqwe	n E m i !_b w E
nemiqwebo	n E m i !_b w E b_< O
nemirarejo	n E m i r a r E d_0Z O
nemithandathu	n E m i t_h a n d a t_h u
nemthl	n E m t_h K
nen	n E n
nenani	n E n a n i
nendatjana	n E n d a tS_> a n a
nendlela	n E n K_b E l a
nendlwana	n E n K_b w a n a
nenlwaneni	n E n l w a n E n i
nenlwanlel	n E n l w a n l E l
nenomboro	n E n O m b O r O
nenovela	n E n O v E l a
nenqathu	n E n !_b a t_h u
nenyawo	n E J a w O
nenza	n E n z a
nepa	n E p_> a
nepahla	n E p_> a K a
nepat	n E p_> a t_h
nepata	n E p_> a t_> a
nepitori	n E p_> i t_> O r i
nepoto	n E p_> O t_> O
neqa	n E !_b a
neqanda	n E !_b a n d a
neqathu	n E !_b a t_h u
neqathula	n E !_b a t_h u l a
neqatjhaza	n E !_b a tS_h a z a
neraso	n E r a s O
nes	n E s
nesela	n E s E l a
nesele	n E s E l E
neselela	n E s E l E l a
nesihlanu	n E s i K a n u
nesikhala	n E s i k_h a l a
nesiko	n E s i k O
nesiphumuzo	n E s i p_h u m u z O
nesiquthu	n E s i !_b u t_h u
nesiquthulu	n E s i !_b u t_h u l u
nesis	n E s i s
nesithanda	n E s i t_h a n d a
nesithandat	n E s i t_h a n d a t_h
nesithandath	n E s i t_h a n d a t_h
nesithandathu	n E s i t_h a n d a t_h u
nesiwa	n E s i w a
nesiwatjho	n E s i w a tS_h O
nesumi	n E s u m i
netheknoloji	n E t_h E k n O l O i
nethob	n E t_h O b_<
nethoba	n E t_h O b_< a
nethobako	n E t_h O b_< a k O
nethosi	n E t_h O s i
netjhumi	n E tS_h u m i
neveni	n E v E n i
newephrovi	n E w E p_h r O v i
newephrovinsi	n E w E p_h r O v i n s i
neyege	n E j E g E
nezala	n E z a l a
nezimvu	n E z i m v u
nezomno	n E z O m n O
nezomnotho	n E z O m n O t_h O
nezwa	n E z w a
ng	N g
nga	N g a
ngaba	N g a b_< a
ngabalethelwa	N g a b_< a l E t_h E l w a
ngabe	N g a b_< E
ngabelethelwa	N g a b_< E l E t_h E l w a
ngabelethwa	N g a b_< E l E t_h w a
ngabesel	N g a b_< E s E l
ngabesele	N g a b_< E s E l E
ngabu	N g a b_< u
ngabuzwa	N g a b_< u z w a
ngafika	N g a f i k a
ngafuduka	N g a f u d u k a
ngahlala	N g a K a l a
ngahlule	N g a K u l E
ngahluleka	N g a K u l E k a
ngajama	N g a d_0Z a m a
ngakho	N g a k_h O
ngakuphi	N g a k u p_h i
ngakutjho	N g a k u tS_h O
ngakuye	N g a k u j E
ngal	N g a l
ngalanga	N g a l a N g a
ngale	N g a l E
ngalesisihlokwana	N g a l E s i s i K O k w a n a
ngalesisirh	N g a l E s i s i x
ngalezi	N g a l E z i
ngalilisa	N g a l i l i s a
ngalo	N g a l O
ngalokho	N g a l O k_h O
ngalokhu	N g a l O k_h u
ngama	N g a m a
ngamadla	N g a m a K_b a
ngamahl	N g a m a K
ngamalanga	N g a m a l a N g a
ngamaled	N g a m a l E d
ngamaledere	N g a m a l E d E r E
ngamalunga	N g a m a l u N g a
ngamambala	N g a m a m b a l a
ngaman	N g a m a n
ngamanane	N g a m a n a n E
ngamananeko	N g a m a n a n E k O
ngamandla	N g a m a n K_b a
ngamane	N g a m a n E
ngamaqanda	N g a m a !_b a n d a
ngamathumbu	N g a m a t_h u m b u
ngamathuthumbo	N g a m a t_h u t_h u m b O
ngamatjhu	N g a m a tS_h u
ngamazi	N g a m a z i
ngamehlo	N g a m E K O
ngamehlokazi	N g a m E K O k a z i
ngamfuduka	N g a m f u d u k a
ngangatholi	N g a N g a t_h O l i
ngangayithola	N g a N g a j i t_h O l a
ngangi	N g a N g i
ngangingatjho	N g a N g i N g a tS_h O
ngangiyatjh	N g a N g i j a tS_h
ngangiyatjho	N g a N g i j a tS_h O
ngani	N g a n i
ngantambama	N g a n t_> a m b a m a
ngap	N g a p_h
ngaph	N g a p_h
ngapha	N g a p_h a
ngaphaka	N g a p_h a k a
ngaphakathi	N g a p_h a k a t_h i
ngaphambi	N g a p_h a m b i
ngaphambikobana	N g a p_h a m b i k O b_< a n a
ngaphandle	N g a p_h a n K_b E
ngaphasi	N g a p_h a s i
ngaphezulu	N g a p_h E z u l u
ngaphi	N g a p_h i
ngaqalisisa	N g a !_b a l i s i s a
ngas	N g a s
ngase	N g a s E
ngasebe	N g a s E b_< E
ngathana	N g a t_h a n a
ngathanda	N g a t_h a n d a
ngathandaz	N g a t_h a n d a z
ngathandaza	N g a t_h a n d a z a
ngathi	N g a t_h i
ngavala	N g a v a l a
ngavela	N g a v E l a
ngawo	N g a w O
ngayibona	N g a j i b_< O n a
ngayithola	N g a j i t_h O l a
ngayo	N g a j O
ngazi	N g a z i
ngazibuza	N g a z i b_< u z a
ngazo	N g a z O
ngci	N |_bg i
nge	N g E
ngebhesini	N g E b E s i n i
ngebhetali	N g E b E t_> a l i
ngebhun	N g E b u n
ngebhundu	N g E b u n d u
ngebronghoro	N g E b_< r O N O r O
ngedongeni	N g E d O N g E n i
ngedorobheni	N g E d O r O b E n i
ngeembhesi	N g E m b E s i
ngeembhesini	N g E m b E s i n i
ngeengcezu	N g E N |_bg E z u
ngeenhl	N g E n K
ngeenhloko	N g E n K O k O
ngeenko	N g E N k O
ngeenkomo	N g E N k O m O
ngeentamo	N g E n t_> a m O
ngefane	N g E f a n E
ngefanelo	N g E f a n E l O
ngegama	N g E g a m a
ngehlabathini	N g E K a b_< a t_h i n i
ngehlathini	N g E K a t_h i n i
ngehlathululo	N g E K a t_h u l u l O
ngehliziyo	N g E K i z i j O
ngejikeni	N g E d_0Z i k E n i
ngekamareni	N g E k a m a r E n i
ngekamurini	N g E k a m u r i n i
ngekhe	N g E k_h E
ngekhwitjhini	N g E k_h w i tS_h i n i
ngekosini	N g E k O s i n i
ngekulungwana	N g E k u l u N g w a n a
ngelan	N g E l a n
ngelanga	N g E l a N g a
ngelizwi	N g E l i z w i
ngelokuthoma	N g E l O k u t_h O m a
ngem	N g E m
ngemehlwe	N g E m E K w E
ngemehlweni	N g E m E K w E n i
ngemfa	N g E m f a
ngemfanelo	N g E m f a n E l O
ngemgqom	N g E m !_bg O m
ngemgqonyini	N g E m !_bg O J i n i
ngemi	N g E m i
ngemilomo	N g E m i l O m O
ngeminyaka	N g E m i J a k a
ngemiqwana	N g E m i !_b w a n a
ngemkobola	N g E m k O b_< O l a
ngemlanje	N g E m l a n d_0Z E
ngemlanjeni	N g E m l a n d_0Z E n i
ngempilo	N g E m p_> i l O
ngemq	N g E m !_b
ngemuva	N g E m u v a
ngemva	N g E m v a
ngemvakwe	N g E m v a k w E
ngen	N g E n
ngendlela	N g E n K_b E l a
ngendleleni	N g E n K_b E l E n i
ngendli	N g E n K_b i
ngendlini	N g E n K_b i n i
ngendlwaneni	N g E n K_b w a n E n i
ngenhlathulu	N g E n K a t_h u l u
ngentam	N g E n t_> a m
ngentamo	N g E n t_> a m O
ngenyanga	N g E J a N g a
ngepelaveke	N g E p_> E l a v E k E
ngepele	N g E p_> E l E
ngepilo	N g E p_> i l O
ngepilwami	N g E p_> i l w a m i
ngepitori	N g E p_> i t_> O r i
ngeplasini	N g E p_h l a s i n i
ngeqiniso	N g E !_b i n i s O
ngeraso	N g E r a s O
ngerhala	N g E x a l a
ngerhalasi	N g E x a l a s i
ngeru	N g E r u
ngerubhini	N g E r u b i n i
nges	N g E s
ngesewula	N g E s E w u l a
ngesi	N g E s i
ngesik	N g E s i k
ngesikhatjhan	N g E s i k_h a tS_h a n
ngesikhatjhana	N g E s i k_h a tS_h a n a
ngesikhum	N g E s i k_h u m
ngesikhumbeni	N g E s i k_h u m b E n i
ngesikoni	N g E s i k O n i
ngesima	N g E s i m a
ngesimanga	N g E s i m a N g a
ngesincele	N g E s i n |_b E l E
ngesinceleni	N g E s i n |_b E l E n i
ngesineke	N g E s i n E k E
ngesinqele	N g E s i n !_b E l E
ngesiphandeni	N g E s i p_h a n d E n i
ngesisuthu	N g E s i s u t_h u
ngesiyabu	N g E s i j a b_< u
ngesiyabus	N g E s i j a b_< u s
ngesiyabuswa	N g E s i j a b_< u s w a
ngeskhatjhan	N g E s k_h a tS_h a n
ngeso	N g E s O
ngesumi	N g E s u m i
ngetjhada	N g E tS_h a d a
ngetjhilani	N g E tS_h i l a n i
ngetlasini	N g E tK_> a s i n i
ngetlhagwini	N g E tK_h a g w i n i
ngetshilani	N g E ts_h i l a n i
ngetswayi	N g E ts_> w a j i
ngevama	N g E v a m a
ngevi	N g E v i
ngevista	N g E v i s t_> a
ngew	N g E w
ngewabotitjhel	N g E w a b_< O t_> i tS_h E l
ngewabotitjhere	N g E w a b_< O t_> i tS_h E r E
ngewakwam	N g E w a k w a m
ngewakwamkhwebani	N g E w a k w a m k_h w E b_< a n i
ngewedlame	N g E w E K_b a m E
ngewedlhamedlhu	N g E w E K_b a m E K_b u
ngey	N g E j
ngeyesi	N g E j E s i
ngeyesibili	N g E j E s i b_< i l i
ngezandla	N g E z a n K_b a
ngeze	N g E z E
ngezi	N g E z i
ngezindlu	N g E z i n K_b u
ngezinye	N g E z i J E
ngezwa	N g E z w a
ngi	N g i
ngibawa	N g i b_< a w a
ngibe	N g i b_< E
ngibelethelwe	N g i b_< E l E t_h E l w E
ngibelethwe	N g i b_< E l E t_h w E
ngibu	N g i b_< u
ngibuhlungu	N g i b_< u K u N g u
ngibuz	N g i b_< u z
ngibuza	N g i b_< u z a
ngibuzelela	N g i b_< u z E l E l a
ngibuzo	N g i b_< u z O
ngibuzobele	N g i b_< u z O b_< E l E
ngibuzobelethwa	N g i b_< u z O b_< E l E t_h w a
ngicabanga	N g i |_b a b_< a N g a
ngidle	N g i K_b E
ngifike	N g i f i k E
ngifuduka	N g i f u d u k a
ngifunde	N g i f u n d E
ngifunduk	N g i f u n d u k
ngifundukwazi	N g i f u n d u k w a z i
ngihlala	N g i K a l a
ngikg	N g i kx g
ngikghona	N g i kx O n a
ngikhethe	N g i k_h E t_h E
ngikho	N g i k_h O
ngikhuluma	N g i k_h u l u m a
ngikhuma	N g i k_h u m a
ngilibo	N g i l i b_< O
ngilibona	N g i l i b_< O n a
ngilis	N g i l i s
ngilise	N g i l i s E
ngilokhu	N g i l O k_h u
ngilowo	N g i l O w O
ngima	N g i m a
ngimi	N g i m i
ngimintu	N g i m i n t_> u
ngimu	N g i m u
ngimumuntu	N g i m u m u n t_> u
ngimuntwenguba	N g i m u n t_> w E N g u b_< a
ngin	N g i n
nginamasum	N g i n a m a s u m
nginamasumi	N g i n a m a s u m i
nginamatjhumi	N g i n a m a tS_h u m i
nginazo	N g i n a z O
ngineminyaka	N g i n E m i J a k a
nginesumi	N g i n E s u m i
nginetjhumi	N g i n E tS_h u m i
nginga	N g i N g a
ngingama	N g i N g a m a
ngingamazi	N g i N g a m a z i
ngingar	N g i N g a r
ngingarareki	N g i N g a r a r E k i
ngingasilo	N g i N g a s i l O
ngingathuki	N g i N g a t_h u k i
ngingazi	N g i N g a z i
ngingenwa	N g i N g E n w a
ngingenwe	N g i N g E n w E
ngingewe	N g i N g E w E
ngingewengubo	N g i N g E w E N g u b_< O
ngingo	N g i N g O
ngingokwamu	N g i N g O k w a m u
ngingonjani	N g i N g O n d_0Z a n i
ngingowako	N g i N g O w a k O
ngingowakwama	N g i N g O w a k w a m a
ngingowakwanzunza	N g i N g O w a k w a n z u n z a
ngingowamandzu	N g i N g O w a m a n dz u
ngingowamandzundza	N g i N g O w a m a n dz u n dz a
ngingowamanzunza	N g i N g O w a m a n z u n z a
ngingumundu	N g i N g u m u n d u
ngingumuntu	N g i N g u m u n t_> u
nginikele	N g i n i k E l E
nginom	N g i n O m
nginombo	N g i n O m b O
nginombono	N g i n O m b O n O
nginomnyaka	N g i n O m J a k a
ngiphe	N g i p_h E
ngipheni	N g i p_h E n i
ngiqabanga	N g i !_b a b_< a N g a
ngiqedi	N g i !_b E d i
ngiqinisile	N g i !_b i n i s i l E
ngirhawukeli	N g i x a w u k E l i
ngisabuza	N g i s a b_< u z a
ngisafuna	N g i s a f u n a
ngisatjho	N g i s a tS_h O
ngisazibuza	N g i s a z i b_< u z a
ngise	N g i s E
ngithenjiswe	N g i t_h E n d_0Z i s w E
ngithi	N g i t_h i
ngithokozamakeso	N g i t_h O k O z a m a k E s O
ngithokozela	N g i t_h O k O z E l a
ngithokozelamak	N g i t_h O k O z E l a m a k
ngithokozelamakeso	N g i t_h O k O z E l a m a k E s O
ngithokozelamakheso	N g i t_h O k O z E l a m a k_h E s O
ngithole	N g i t_h O l E
ngitjhadi	N g i tS_h a d i
ngitjhadil	N g i tS_h a d i l
ngitjhadile	N g i tS_h a d i l E
ngitjho	N g i tS_h O
ngivike	N g i v i k E
ngiwesatjiswa	N g i w E s a tS_> i s w a
ngiwo	N g i w O
ngiyabona	N g i j a b_< O n a
ngiyenga	N g i j E N g a
ngiyifetjhe	N g i j i f E tS_h E
ngiyifetjhen	N g i j i f E tS_h E n
ngiyifetjheni	N g i j i f E tS_h E n i
ngiyo	N g i j O
ngiyokubona	N g i j O k u b_< O n a
ngiza	N g i z a
ngizakhulu	N g i z a k_h u l u
ngizakubedlha	N g i z a k u b_< E K_b a
ngizakukhulumela	N g i z a k u k_h u l u m E l a
ngizakunqo	N g i z a k u n !_b O
ngizakuqonda	N g i z a k u !_b O n d a
ngizakuzikhulumela	N g i z a k u z i k_h u l u m E l a
ngizama	N g i z a m a
ngizazikhulumela	N g i z a z i k_h u l u m E l a
ngizazomnikela	N g i z a z O m n i k E l a
ngize	N g i z E
ngizibona	N g i z i b_< O n a
ngiziqinisile	N g i z i !_b i n i s i l E
ngizo	N g i z O
ngizok	N g i z O k
ngizokubelethwa	N g i z O k u b_< E l E t_h w a
ngizokufunda	N g i z O k u f u n d a
ngizokusebenzela	N g i z O k u s E b_< E n z E l a
ngizokuveza	N g i z O k u v E z a
ngizowa	N g i z O w a
ngizoziveza	N g i z O z i v E z a
ngizozivezela	N g i z O z i v E z E l a
ngo	N g O
ngoba	N g O b_< a
ngobana	N g O b_< a n a
ngobanyana	N g O b_< a J a n a
ngobu	N g O b_< u
ngobuvila	N g O b_< u v i l a
ngojulayi	N g O d_0Z u l a j i
ngok	N g O k
ngoko	N g O k O
ngokobana	N g O k O b_< a n a
ngokomthetho	N g O k O m t_h E t_h O
ngoku	N g O k u
ngokuba	N g O k u b_< a
ngokubanjwa	N g O k u b_< a n d_0Z w a
ngokubotjhwa	N g O k u b_< O tS_h w a
ngokugande	N g O k u g a n d E
ngokukhamba	N g O k u k_h a m b a
ngokumgandelela	N g O k u m g a n d E l E l a
ngokumhlophe	N g O k u m K O p_h E
ngokun	N g O k u n
ngokunukelela	N g O k u n u k E l E l a
ngokurabhela	N g O k u r a b E l a
ngokurhabe	N g O k u x a b_< E
ngokuthatha	N g O k u t_h a t_h a
ngokuthi	N g O k u t_h i
ngokuthiwa	N g O k u t_h i w a
ngokuthoma	N g O k u t_h O m a
ngokuyelela	N g O k u j E l E l a
ngokuyokuthutha	N g O k u j O k u t_h u t_h a
ngokwen	N g O k w E n
ngokwenta	N g O k w E n t_> a
ngokwentando	N g O k w E n t_> a n d O
ngom	N g O m
ngomahluko	N g O m a K u k O
ngombana	N g O m b a n a
ngombanya	N g O m b a J a
ngombanyana	N g O m b a J a n a
ngomgqibelo	N g O m !_bg i b_< E l O
ngomhla	N g O m K a
ngomhlaka	N g O m K a k a
ngomhlanga	N g O m K a N g a
ngomhlangan	N g O m K a N g a n
ngomhlangano	N g O m K a N g a n O
ngomhlawetjhumi	N g O m K a w E tS_h u m i
ngomhlolanja	N g O m K O l a n d_0Z a
ngomlomo	N g O m l O m O
ngomncamo	N g O m n |_b a m O
ngomntanthu	N g O m n t_> a n t_h u
ngomu	N g O m u
ngomukhwakho	N g O m u k_h w a k_h O
ngomuntu	N g O m u n t_> u
ngomva	N g O m v a
ngonobay	N g O n O b_< a j
ngonobayeni	N g O n O b_< a j E n i
ngonyaka	N g O J a k a
ngqi	N !_bg i
ngu	N g u
ngubani	N g u b_< a n i
ngubo	N g u b_< O
ngufelani	N g u f E l a n i
ngufene	N g u f E n E
ngugalajana	N g u g a l a d_0Z a n a
ngugalakajana	N g u g a l a k a d_0Z a n a
ngugalakajani	N g u g a l a k a d_0Z a n i
ngugogo	N g u g O g O
ngukhipha	N g u k_h i p_h a
ngukhule	N g u k_h u l E
ngukhulelaphi	N g u k_h u l E l a p_h i
ngukhulelwaphi	N g u k_h u l E l w a p_h i
ngukunye	N g u k u J E
ngum	N g u m
ngumasa	N g u m a s a
ngumasang	N g u m a s a N g
ngumasango	N g u m a s a N g O
ngumazo	N g u m a z O
ngumhla	N g u m K a
ngumnguni	N g u m N g u n i
ngumngwengweni	N g u m N g w E N g w E n i
ngumuda	N g u m u d a
ngumuntu	N g u m u n t_> u
ngun	N g u n
nguna	N g u n a
ngunanyana	N g u n a J a n a
ngungci	N g u N |_bg i
ngungqi	N g u N !_bg i
nguskhosana	N g u s k_h O s a n a
nguwe	N g u w E
nguye	N g u j E
nguzinyo	N g u z i J O
nguzondani	N g u z O n d a n i
nguzondi	N g u z O n d i
ngwakwamkhwebani	N g w a k w a m k_h w E b_< a n i
nigel	n i g E l
nilalelwe	n i l a l E l w E
nin	n i n
nineteen	n i n E t_> E n
ning	n i N g
ningarareki	n i N g a r a r E k i
ningatjh	n i N g a tS_h
ningatjho	n i N g a tS_h O
nj	n d_0Z
njalo	n d_0Z a l O
njan	n d_0Z a n
njani	n d_0Z a n i
nje	n d_0Z E
njemang	n d_0Z E m a N g
njen	n d_0Z E n
njeng	n d_0Z E N g
njengaba	n d_0Z E N g a b_< a
njengabas	n d_0Z E N g a b_< a s
njengabase	n d_0Z E N g a b_< a s E
njengabesanyana	n d_0Z E N g a b_< E s a J a n a
njengama	n d_0Z E N g a m a
njengamakhana	n d_0Z E N g a m a k_h a n a
njengamakhwana	n d_0Z E N g a m a k_h w a n a
njengamkha	n d_0Z E N g a m k_h a
njengamkhana	n d_0Z E N g a m k_h a n a
njengamtjhana	n d_0Z E N g a m tS_h a n a
njengamu	n d_0Z E N g a m u
njenganamkhana	n d_0Z E N g a n a m k_h a n a
njenge	n d_0Z E N g E
njengekutana	n d_0Z E N g E k u t_> a n a
njengekutani	n d_0Z E N g E k u t_> a n i
njengemo	n d_0Z E N g E m O
njengendoda	n d_0Z E N g E n d O d a
njengentethe	n d_0Z E N g E n t_> E t_h E
njengepukani	n d_0Z E N g E p_> u k a n i
njengesakhamuzi	n d_0Z E N g E s a k_h a m u z i
njengesifundo	n d_0Z E N g E s i f u n d O
njengesipinitjhi	n d_0Z E N g E s i p_> i n i tS_h i
njengespinitjhi	n d_0Z E N g E s p_> i n i tS_h i
njengo	n d_0Z E N g O
njengobana	n d_0Z E N g O b_< a n a
njengobuq	n d_0Z E N g O b_< u !_b
njengobuqhaka	n d_0Z E N g O b_< u !_bh a k a
njengokuba	n d_0Z E N g O k u b_< a
njengom	n d_0Z E N g O m
njengombana	n d_0Z E N g O m b a n a
njengomfundi	n d_0Z E N g O m f u n d i
njengomfundisi	n d_0Z E N g O m f u n d i s i
njengomkakhe	n d_0Z E N g O m k a k_h E
njengomntazanyana	n d_0Z E N g O m n t_> a z a J a n a
njengomuntu	n d_0Z E N g O m u n t_> u
njengonjani	n d_0Z E N g O n d_0Z a n i
njesi	n d_0Z E s i
njiwa	n d_0Z i w a
no	n O
nob	n O b_<
nobayeni	n O b_< a j E n i
nobugebengu	n O b_< u g E b_< E N g u
nobuna	n O b_< u n a
nobunaba	n O b_< u n a b_< a
nobunane	n O b_< u n a n E
nofana	n O f a n a
nogh	n O
nogotjiwe	n O g O tS_> i w E
nohlaza	n O K a z a
nojanson	n O a n s O n
nokho	n O k_h O
nokhunye	n O k_h u J E
noku	n O k u
nokubaleka	n O k u b_< a l E k a
nokubili	n O k u b_< i l i
nokubizwa	n O k u b_< i z w a
nokubunabisa	n O k u b_< u n a b_< i s a
nokudla	n O k u K_b a
nokuga	n O k u g a
nokuk	n O k u k
nokukhamba	n O k u k_h a m b a
nokulala	n O k u l a l a
nokulalela	n O k u l a l E l a
nokulinga	n O k u l i N g a
nokun	n O k u n
nokunabisa	n O k u n a b_< i s a
nokune	n O k u n E
nokunga	n O k u N g a
nokungan	n O k u N g a n
nokungani	n O k u N g a n i
nokunganisana	n O k u N g a n i s a n a
nokunganisani	n O k u N g a n i s a n i
nokungasi	n O k u N g a s i
nokunikela	n O k u n i k E l a
nokunye	n O k u J E
nokuphatha	n O k u p_h a t_h a
nokuphendula	n O k u p_h E n d u l a
nokuthola	n O k u t_h O l a
nokuthukiswa	n O k u t_h u k i s w a
nokuthuthukisa	n O k u t_h u t_h u k i s a
nokuthuthukiswa	n O k u t_h u t_h u k i s w a
nokutjhayela	n O k u tS_h a j E l a
nokutlikitla	n O k u tK_> i k i tK_> a
nokuvakatjha	n O k u v a k a tS_h a
nokuvik	n O k u v i k
nokuvikela	n O k u v i k E l a
nokuvikeleka	n O k u v i k E l E k a
nokuzithabisa	n O k u z i t_h a b_< i s a
nom	n O m
noma	n O m a
nomanala	n O m a n a l a
nomasa	n O m a s a
nomasango	n O m a s a N g O
nomdlalo	n O m K_b a l O
nomkhono	n O m k_h O n O
nomlenze	n O m l E n z E
nommango	n O m m a N g O
nomnta	n O m n t_> a
nomntanthu	n O m n t_> a n t_h u
nomnyaka	n O m J a k a
nomqondo	n O m !_b O n d O
nomramurwamu	n O m r a m u r w a m u
nomraro	n O m r a r O
nomrharibakhe	n O m x a r i b_< a k_h E
nomrwamurwamu	n O m r w a m u r w a m u
nomthetho	n O m t_h E t_h O
nomthethosisekelo	n O m t_h E t_h O s i s E k E l O
nomuda	n O m u d a
nomunye	n O m u J E
nomzana	n O m z a n a
nonamgidi	n O n a m g i d i
nongqi	n O N !_bg i
nontuli	n O n t_> u l i
nonyaka	n O J a k a
norwa	n O r w a
norwamurwamu	n O r w a m u r w a m u
nosemnyameni	n O s E m J a m E n i
noskhosana	n O s k_h O s a n a
not	n O t_h
noyedwa	n O j E d w a
ntando	n t_> a n d O
ntanga	n t_> a N g a
ntangan	n t_> a N g a n
ntathu	n t_> a t_h u
ntu	n t_> u
ntwengubo	n t_> w E N g u b_< O
number	n u m b E r
nyanana	J a n a n a
nzekela	n z E k E l a
nziwa	n z i w a
o	O
obahlanza	O b_< a K a n z a
obahlaza	O b_< a K a z a
obawu	O b_< a w u
obekakhona	O b_< E k a k_h O n a
obekumenza	O b_< E k u m E n z a
obomvu	O b_< O m v u
obucocwako	O b_< u |_b O |_b w a k O
obufuthumelako	O b_< u f u t_h u m E l a k O
obukha	O b_< u k_h a
obukhalim	O b_< u k_h a l i m
obukhalimako	O b_< u k_h a l i m a k O
obukhan	O b_< u k_h a n
obul	O b_< u l
obulikghono	O b_< u l i kx O n O
obulinghono	O b_< u l i N O n O
obunane	O b_< u n a n E
odlala	O K_b a l a
odosa	O d O s a
of	O f
ofisi	O f i s i
ogade	O g a d E
ogadungileko	O g a d u N g i l E k O
ogadungileo	O g a d u N g i l E O
ogqonyini	O !_bg O J i n i
oh	O
ohl	O K
ohla	O K a
ohlala	O K a l a
ohlangana	O K a N g a n a
ohlanza	O K a n z a
ohlaza	O K a z a
ok	O k
okay	O k a j
okhona	O k_h O n a
okhunye	O k_h u J E
okiyi	O k i j i
okiyo	O k i j O
okonakeleko	O k O n a k E l E k O
oku	O k u
okubarara	O k u b_< a r a r a
okubararako	O k u b_< a r a r a k O
okube	O k u b_< E
okubonakeleko	O k u b_< O n a k E l E k O
okubuye	O k u b_< u j E
okucatjangwa	O k u |_b a tS_> a N g w a
okufuze	O k u f u z E
okukghan	O k u kx a n
okukghantjhiswa	O k u kx a n tS_h i s w a
okukghatj	O k u kx a tS_h
okukghatjiswa	O k u kx a tS_> i s w a
okukghatjiswe	O k u kx a tS_> i s w E
okukghatjswa	O k u kx a tS_h s w a
okulu	O k u l u
okulunga	O k u l u N g a
okumele	O k u m E l E
okumnan	O k u m n a n
okumnandi	O k u m n a n d i
okuna	O k u n a
okunenyama	O k u n E J a m a
okungiwo	O k u N g i w O
okungiyo	O k u N g i j O
okuqakatheki	O k u !_b a k a t_h E k i
okuqakathekileko	O k u !_b a k a t_h E k i l E k O
okuqakileko	O k u !_b a k i l E k O
okurhatjiswa	O k u x a tS_> i s w a
okutjho	O k u tS_h O
okuzijameleko	O k u z i d_0Z a m E l E k O
okwabonwa	O k w a b_< O n w a
okwan	O k w a n
olakala	O l a k a l a
olande	O l a n d E
olandela	O l a n d E l a
olandelako	O l a n d E l a k O
oli	O l i
oligugu	O l i g u g u
olihlawulako	O l i K a w u l a k O
olihlawulela	O l i K a w u l E l a
olihlawulelako	O l i K a w u l E l a k O
olihlawuli	O l i K a w u l i
olisumi	O l i s u m i
omele	O m E l E
omhlophe	O m K O p_h E
ominyaka	O m i J a k a
omkhudlwana	O m k_h u K_b w a n a
omkhulu	O m k_h u l u
omuhle	O m u K E
omunye	O m u J E
ong	O N g
ongahl	O N g a K
ongahlu	O N g a K u
ongahluthulelwa	O N g a K u t_h u l E l w a
ongasekho	O N g a s E k_h O
ongazithathe	O N g a z i t_h a t_h E
onyakeni	O J a k E n i
onzima	O n z i m a
orara	O r a r a
os	O s
osarulani	O s a r u l a n i
osele	O s E l E
osendleleni	O s E n K_b E l E n i
osif	O s i f
osifunda	O s i f u n d a
osifundiso	O s i f u n d i s O
osifundo	O s i f u n d O
osithandwa	O s i t_h a n d w a
osithwandwa	O s i t_h w a n d w a
owahlan	O w a K a n
owakh	O w a k_h
owakhe	O w a k_h E
owakhuphe	O w a k_h u p_h E
owalandelako	O w a l a n d E l a k O
owathulel	O w a t_h u l E l
owathulelwa	O w a t_h u l E l w a
owawu	O w a w u
owawubanjwe	O w a w u b_< a n d_0Z w E
owazi	O w a z i
owethulelwa	O w E t_h u l E l w a
owodw	O w O d w
owodwa	O w O d w a
owodwo	O w O d w O
oyikulungwana	O j i k_> u l u N g w a n a
oyikulungwane	O j i k_> u l u N g w a n E
oyikungwana	O j i k_> u N g w a n a
oyinkulungwana	O j i N k_> u l u N g w a n a
oyinkulungwani	O j i N k_> u l u N g w a n i
ozakwenzi	O z a k w E n z i
ozakwenziwa	O z a k w E n z i w a
ozimele	O z i m E l E
ozinkulungwana	O z i N k_> u l u N g w a n a
p	p_h
phakathi	p_h a k a t_h i
phambi	p_h a m b i
phambili	p_h a m b i l i
phas	p_h a s
phasi	p_h a s i
phatjha	p_h a tS_h a
phela	p_h E l a
pheze	p_h E z E
phezu	p_h E z u
phezulu	p_h E z u l u
philadelphia	p_h i l a d E l p_h i a
pieterskraal	p_> i E t_> E r s k r a a l
pitor	p_> i t_> O r
pitori	p_> i t_> O r i
plastic	p_h l a s t_> i |_b
pretoria	p_h r E t_> O r i a
printer	p_h r i n t_> E r
printers	p_h r i n t_> E r s
publication	p_> u b_< l i |_b a t_> i O n
puke	p_> u k E
puplica	p_> u p_h l i |_b a
puplication	p_> u p_h l i |_b a t_> i O n
q	!_b
qala	!_b a l a
qalani	!_b a l a n i
qalaqale	!_b a l a !_b a l E
qalisisa	!_b a l i s i s a
qanda	!_b a n d a
qatjhaza	!_b a tS_h a z a
qatjhazi	!_b a tS_h a z i
qhatjhaza	!_bh a tS_h a z a
qhegu	!_bh E g u
qhifi	!_bh i f i
qifi	!_b i f i
r	r
ra	r a
rabhalala	r a b a l a l a
rareka	r a r E k a
rathu	r a t_h u
residi	r E s i d i
rh	x
rhaba	x a b_< a
rhoboyi	x O b_< O j i
rivier	r i v i E r
s	s
sabe	s a b_< E
sabulawa	s a b_< u l a w a
sabwa	s a b_< w a
saduma	s a d u m a
saf	s a f
safukama	s a f u k a m a
sahlala	s a K a l a
sahlaliseki	s a K a l i s E k i
sakababa	s a k a b_< a b_< a
sakayise	s a k a j i s E
sakhe	s a k_h E
sakhwela	s a k_h w E l a
sakosi	s a k O s i
sakosigodo	s a k O s i g O d O
sakosigodwes	s a k O s i g O d w E s
sakwasigodo	s a k w a s i g O d O
sam	s a m
sama	s a m a
samaf	s a m a f
samafu	s a m a f u
samtho	s a m t_h O
samukelwa	s a m u k E l w a
sange	s a N g E
sangemedhlela	s a N g E m E d K E l a
saphandhlusela	s a p_h a n d K u s E l a
saphandlusela	s a p_h a n K_b u s E l a
sas	s a s
sase	s a s E
sasise	s a s i s E
sasu	s a s u
sasulwa	s a s u l w a
sathola	s a t_h O l a
satjhidela	s a tS_h i d E l a
satjhinga	s a tS_h i N g a
saw	s a w
sawawisa	s a w a w i s a
sawu	s a w u
sawusulwa	s a w u s u l w a
sayidula	s a j i d u l a
sayis	s a j i s
sayisunduza	s a j i s u n d u z a
sayo	s a j O
sazithola	s a z i t_h O l a
scandinavia	s |_b a n d i n a v i a
se	s E
sebalayitjhile	s E b_< a l a j i tS_h i l E
sebawa	s E b_< a w a
sebawal	s E b_< a w a l
sebawalayitjhe	s E b_< a w a l a j i tS_h E
sebawalayitjhela	s E b_< a w a l a j i tS_h E l a
sebawalayitjhile	s E b_< a w a l a j i tS_h i l E
sebawatjhiyile	s E b_< a w a tS_h i j i l E
sebawol	s E b_< a w O l
sebawolitjhiyile	s E b_< a w O l i tS_h i j i l E
sebele	s E b_< E l E
sebizo	s E b_< i z O
section	s E |_b t_> i O n
seenkomo	s E N k_> O m O
sefonetiki	s E f O n E t_> i k i
segreyidi	s E g r E j i d i
seka	s E k a
sekade	s E k a d E
sekadi	s E k a d i
sekadidi	s E k a d i d i
sekadilizi	s E k a d i l i z i
sekadilizile	s E k a d i l i z i l E
sekadindilizile	s E k a d i n d i l i z i l E
sekadingiz	s E k a d i N g i z
sekadingizela	s E k a d i N g i z E l a
sekalafoni	s E k a l a f O n i
sekandilizile	s E k a n d i l i z i l E
seke	s E k E
sekharikhyulamu	s E k_h a r i k_h j u l a m u
seko	s E k O
sekonake	s E k O n a k E
sekonakele	s E k O n a k E l E
seks	s E k s
sekusile	s E k_> u s i l E
sekuthwase	s E k u t_h w a s E
sekwezwakala	s E k w E z w a k a l a
selacabanga	s E l a |_b a b_< a N g a
seladindize	s E l a d i n d i z E
selafikile	s E l a f i k i l E
selakad	s E l a k a d
selakade	s E l a k a d E
selala	s E l a l a
selalahle	s E l a l a K E
selalahleka	s E l a l a K E k a
selalahleki	s E l a l a K E k i
selalahlekile	s E l a l a K E k i l E
selaqabanga	s E l a !_b a b_< a N g a
selborne	s E l b_< O r n E
sele	s E l E
selebakade	s E l E b_< a k a d E
selenyuke	s E l E J u k E
selenyuki	s E l E J u k i
selenyukile	s E l E J u k i l E
selikade	s E l i k a d E
selikhu	s E l i k_h u
selikhulumisana	s E l i k_h u l u m i s a n a
selilinganise	s E l i l i N g a n i s E
selizweloke	s E l i z w E l O k E
semadlangeni	s E m a K_b a N g E n i
semahlombe	s E m a K O m b E
sembongi	s E m b O N g i
semtatweni	s E m t_> a t_> w E n i
semth	s E m t_h
semtha	s E m t_h a
semtlhaleni	s E m tK_h a l E n i
seng	s E N g
sengi	s E N g i
sengibuhlungu	s E N g i b_< u K u N g u
sengihlala	s E N g i K a l a
sengimaratha	s E N g i m a r a t_h a
sengiyijamise	s E N g i j i d_0Z a m i s E
sengiza	s E N g i z a
sengizibona	s E N g i z i b_< O n a
senziwa	s E n z i w a
sephi	s E p_h i
ses	s E s
sesalithi	s E s a l i t_h i
sese	s E s E
sesenzo	s E s E n z O
sesewula	s E s E w u l a
sesibili	s E s i b_< i l i
sesilithi	s E s i l i t_h i
sesingene	s E s i N g E n E
sesingenile	s E s i N g E n i l E
sesiyabuswa	s E s i j a b_< u s w a
setonini	s E t_> O n i n i
seventy	s E v E n t_> j
sewabalayitjha	s E w a b_< a l a j i tS_h a
sewawisa	s E w a w i s a
sewuyagul	s E w u j a g u l
sewuyagula	s E w u j a g u l a
seyicabanga	s E j i |_b a b_< a N g a
seyilayitjhe	s E j i l a j i tS_h E
seyilayitjhile	s E j i l a j i tS_h i l E
seyiqabange	s E j i !_b a b_< a N g E
seyiqanda	s E j i !_b a n d a
sezilala	s E z i l a l a
sezilalalala	s E z i l a l a l a l a
sezwa	s E z w a
sezwakala	s E z w a k a l a
si	s i
sibhedlela	s i b E K_b E l a
sibili	s i b_< i l i
sibon	s i b_< O n
sibona	s i b_< O n a
sibone	s i b_< O n E
sichotjeni	s i |_bh O tS_> E n i
sifu	s i f u
sigagawuroba	s i g a g a w u r O b_< a
sihlanu	s i K a n u
sihlomelela	s i K O m E l E l a
sihlomelelo	s i K O m E l E l O
sihlukane	s i K u k a n E
sijamele	s i d_0Z a m E l E
sikababa	s i k a b_< a b_< a
sikakholiwe	s i k a k_h O l i w E
sikam	s i k a m
sikamhlalukwana	s i k a m K a l u k w a n a
sikamhlawu	s i k a m K a w u
sikamhlawulani	s i k a m K a w u l a n i
sikandzundza	s i k a n dz u n dz a
sikayise	s i k a j i s E
sikazomba	s i k a z O m b a
sikghhona	s i kx O n a
sikghona	s i kx O n a
sikhala	s i k_h a l a
sikhamba	s i k_h a m b a
sikhol	s i k_h O l
sikhomba	s i k_h O m b a
sikhombisa	s i k_h O m b i s a
sikhozi	s i k_h O z i
sikhuluma	s i k_h u l u m a
siku	s i k u
sikulethele	s i k u l E t_h E l E
sikuthulele	s i k u t_h u l E l E
sikuval	s i k u v a l
sikuvalele	s i k u v a l E l E
silinge	s i l i N g E
silo	s i l O
sim	s i m
simbawele	s i m b a w E l E
simthole	s i m t_h O l E
sin	s i n
sindebe	s i n d E b_< E
sindebel	s i n d E b_< E l
sindebele	s i n d E b_< E l E
sindeben	s i n d E b_< E n
sineka	s i n E k a
sinekani	s i n E k a n i
sing	s i N g
singamane	s i N g a m a n E
singamrhug	s i N g a m x u g
singamrhuga	s i N g a m x u g a
singamurhuga	s i N g a m u x u g a
singawumorosa	s i N g a w u m O r O s a
singaze	s i N g a z E
singazenza	s i N g a z E n z a
singekho	s i N g E k_h O
singena	s i N g E n a
singenza	s i N g E n z a
singenzani	s i N g E n z a n i
singezwa	s i N g E z w a
sinodolo	s i n O d O l O
sinokudla	s i n O k u K_b a
sinomdumo	s i n O m d u m O
sinondolo	s i n O n d O l O
sinqophe	s i n !_b O p_h E
sinyikhaba	s i J i k_h a b_< a
siphump	s i p_h u m p_h
siphumputha	s i p_h u m p_> u t_h a
siqabanga	s i !_b a b_< a N g a
siqo	s i !_b O
sirareka	s i r a r E k a
sirarekile	s i r a r E k i l E
sis	s i s
sisa	s i s a
sisekela	s i s E k E l a
sisen	s i s E n
sithanda	s i t_h a n d a
sithandat	s i t_h a n d a t_h
sithandath	s i t_h a n d a t_h
sithandathu	s i t_h a n d a t_h u
sithathu	s i t_h a t_h u
sithi	s i t_h i
sithola	s i t_h O l a
sitjetjhe	s i tS_> E tS_h E
sitjhaba	s i tS_h a b_< a
sitjheje	s i tS_h E d_0Z E
siwatlhadlhula	s i w a tK_h a K_b u l a
siwubona	s i w u b_< O n a
siwuhloniphe	s i w u K O n i p_h E
siya	s i j a
siyabus	s i j a b_< u s
siyabusw	s i j a b_< u s w
siyabuswa	s i j a b_< u s w a
siyavuka	s i j a v u k a
siyokufika	s i j O k u f i k a
siyoz	s i j O z
siyozithengi	s i j O z i t_h E N g i
siyozithengis	s i j O z i t_h E N g i s
siyozithengisa	s i j O z i t_h E N g i s a
siza	s i z a
sizakuthola	s i z a k u t_h O l a
sizazithola	s i z a z i t_h O l a
sizitjhiye	s i z i tS_h i j E
sizitjhiyele	s i z i tS_h i j E l E
sizokub	s i z O k u b_<
sizokubamba	s i z O k u b_< a m b a
sizokubhalelwa	s i z O k u b a l E l w a
sizowafaka	s i z O w a f a k a
skhosana	s k_h O s a n a
so	s O
sobu	s O b_< u
sobuthakgha	s O b_< u t_h a kx a
solo	s O l O
somthetho	s O m t_h E t_h O
sonodolo	s O n O d O l O
sorry	s O r r j
soshanguv	s O s a N g u v
sosinondolo	s O s i n O n d O l O
sosudu	s O s u d u
sosuthu	s O s u t_h u
sound	s O u n d
southern	s O u t_h E r n
soweto	s O w E t_> O
sphandeni	s p_h a n d E n i
sphil	s p_h i l
springs	s p_h r i N g s
sthanda	s t_h a n d a
sthlanu	s t_h K a n u
suka	s u k a
sumi	s u m i
sunduza	s u n d u z a
sunnyside	s u n J s i d E
susa	s u s a
system	s j s t_> E m
t	t_h
tantweni	t_> a n t_> w E n i
tatweni	t_> a t_> w E n i
taxis	t_> a x i s
text	t_> E x t_h
texts	t_> E x ts_>
thala	t_h a l a
thandathu	t_h a n d a t_h u
thara	t_h a r a
thatha	t_h a t_h a
thathe	t_h a t_h E
thathu	t_h a t_h u
the	t_h E
thelwa	t_h E l w a
thi	t_h i
thileko	t_h i l E k O
thina	t_h i n a
thlanu	t_h K a n u
thob	t_h O b_<
thoba	t_h O b_< a
thoma	t_h O m a
thu	t_h u
tjhadi	tS_h a d i
tjhile	tS_h i l E
tjhiswe	tS_h i s w E
tjhum	tS_h u m
tjhuma	tS_h u m a
tjhumi	tS_h u m i
tjhuminahlan	tS_h u m i n a K a n
tjuti	tS_h d_0Z u t_> i
town	t_> O w n
trans	t_h r a n s
transvaal	t_h r a n s v a a l
tshadil	ts_h a d i l
tshu	ts_h u
tshwane	ts_h w a n E
tswela	ts_> w E l a
twe	t_> w E
tweefontein	t_> w E f O n t_> E i n
two	t_> w O
u	u
ub	u b_<
ubadanile	u b_< a d a n i l E
ubamkhu	u b_< a m k_h u
ubamkhulu	u b_< a m k_h u l u
ube	u b_< E
ubeka	u b_< E k a
ubeke	u b_< E k E
ubezwe	u b_< E z w E
ubo	u b_< O
ubong	u b_< O N g
ubongw	u b_< O N g w
ubongwe	u b_< O N g w E
ubu	u b_< u
ubujadujadu	u b_< u d_0Z a d u d_0Z a d u
ubujamo	u b_< u d_0Z a m O
ubulawuli	u b_< u l a w u l i
ubumongameli	u b_< u m O N g a m E l i
ubuntu	u b_< u n t_> u
ubunya	u b_< u J a
ubupente	u b_< u p_> E n t_> E
uburhiqwa	u b_< u x i !_b w a
uburotho	u b_< u r O t_h O
ubusuku	u b_< u s u k u
ubuthakgha	u b_< u t_h a kx a
ubuthankgha	u b_< u t_h a N kx a
ubuza	u b_< u z a
ud	u d
udade	u d a d E
udadwabo	u d a d w a b_< O
udanile	u d a n i l E
udanyeli	u d a J E l i
udladla	u K_b a K_b a
udorhodere	u d O x O d E r E
udulek	u d u l E k
uduleka	u d u l E k a
uge	u g E
ugethwe	u g E t_h w E
ugij	u g i d_0Z
ugiji	u g i d_0Z i
ugogo	u g O g O
ugotjiwe	u g O tS_> i w E
ugubudu	u g u b_< u d u
uhla	u K a
uhlala	u K a l a
uhlalaphi	u K a l a p_h i
uhlangana	u K a N g a n a
uhlezi	u K E z i
uhlezin	u K E z i n
uhleziphi	u K E z i p_h i
uhloko	u K O k O
uhlung	u K u N g
uja	u d_0Z a
ujuguja	u d_0Z u g u d_0Z a
uk	u k
uke	u k E
ukha	u k_h a
ukhamba	u k_h a m b a
ukhohl	u k_h O K
ukholi	u k_h O l i
ukholiwe	u k_h O l i w E
ukhomba	u k_h O m b a
ukhukhulamungu	u k_h u k_h u l a m u N g u
ukobana	u k O b_< a n a
uku	u k u
ukubaleka	u k u b_< a l E k a
ukubalekela	u k u b_< a l E k E l a
ukubamba	u k u b_< a m b a
ukube	u k u b_< E
ukubelethwa	u k u b_< E l E t_h w a
ukubola	u k u b_< O l a
ukubona	u k u b_< O n a
ukudl	u k u K_b
ukudla	u k u K_b a
ukudo	u k u d O
ukudobha	u k u d O b a
ukudobhadobha	u k u d O b a d O b a
ukufaka	u k u f a k a
ukufu	u k u f u
ukufuya	u k u f u j a
ukufuz	u k u f u z
ukufuza	u k u f u z a
ukugijima	u k u g i d_0Z i m a
ukuguqweni	u k u g u !_b w E n i
ukukhamba	u k u k_h a m b a
ukukhuluma	u k u k_h u l u m a
ukukweqa	u k u k w E !_b a
ukula	u k u l a
ukulahlekelwa	u k u l a K E k E l w a
ukulalela	u k u l a l E l a
ukulande	u k u l a n d E
ukulandela	u k u l a n d E l a
ukulandelela	u k u l a n d E l E l a
ukulwa	u k u l w a
ukumthola	u k u m t_h O l a
ukumthuma	u k u m t_h u m a
ukumtjela	u k u m tS_> E l a
ukung	u k u N g
ukungakhambisani	u k u N g a k_h a m b i s a n i
ukungathembani	u k u N g a t_h E m b a n i
ukungathembi	u k u N g a t_h E m b i
ukungitjela	u k u N g i tS_> E l a
ukup	u k u p_h
ukuphi	u k u p_h i
ukuphil	u k u p_h i l
ukuphila	u k u p_h i l a
ukuphumula	u k u p_h u m u l a
ukuphungula	u k u p_h u N g u l a
ukuqinisek	u k u !_b i n i s E k
ukuqinisela	u k u !_b i n i s E l a
ukura	u k u r a
ukuratharatha	u k u r a t_h a r a t_h a
ukuratharathokho	u k u r a t_h a r a t_h O k_h O
ukus	u k u s
ukusenga	u k u s E N g a
ukusengela	u k u s E N g E l a
ukusiza	u k u s i z a
ukuth	u k u t_h
ukuthat	u k u t_h a t_h
ukuthatha	u k u t_h a t_h a
ukuthengela	u k u t_h E N g E l a
ukuthintanisa	u k u t_h i n t_> a n i s a
ukuthutha	u k u t_h u t_h a
ukutjela	u k u tS_> E l a
ukutjhayela	u k u tS_h a j E l a
ukutjheja	u k u tS_h E d_0Z a
ukutjho	u k u tS_h O
ukutlola	u k u tK_> O l a
ukutlolisa	u k u tK_> O l i s a
ukuvuthwa	u k u v u t_h w a
ukuwa	u k u w a
ukuwu	u k u w u
ukuwuf	u k u w u f
ukuwufuza	u k u w u f u z a
ukuwuphungula	u k u w u p_h u N g u l a
ukuyokufuna	u k u j O k u f u n a
ukuyokufunda	u k u j O k u f u n d a
ukuyokuthenga	u k u j O k u t_h E N g a
ukuze	u k u z E
ukuzisa	u k u z i s a
ukuzisiza	u k u z i s i z a
ukwakhiwa	u k w a k_h i w a
ukwazi	u k w a z i
ukwemba	u k w E m b a
ukweqa	u k w E !_b a
ulukhul	u l u k_h u l
um	u m
uma	u m a
umabi	u m a b_< i
umabinzana	u m a b_< i n z a n a
umabuse	u m a b_< u s E
umadibizan	u m a d i b_< i z a n
umakg	u m a kx g
umakgh	u m a kx
umakghwanyela	u m a kx w a J E l a
umakghwayeja	u m a kx w a j E d_0Z a
umakgwayeja	u m a kx g w a j E d_0Z a
umakhonyeja	u m a k_h O J E d_0Z a
umal	u m a l
umaliledinini	u m a l i l E d i n i n i
umalume	u m a l u m E
umalusi	u m a l u s i
umarhwayeja	u m a x w a j E d_0Z a
umarikiriki	u m a r i k i r i k i
umasa	u m a s a
umasango	u m a s a N g O
umasi	u m a s i
umasibu	u m a s i b_< u
umasibuse	u m a s i b_< u s E
umatshwayo	u m a ts_h w a j O
umave	u m a v E
umavel	u m a v E l
umavela	u m a v E l a
umaz	u m a z
umazi	u m a z i
umazibu	u m a z i b_< u
umazibukwese	u m a z i b_< u k w E s E
umazibuse	u m a z i b_< u s E
umazibusele	u m a z i b_< u s E l E
umazila	u m a z i l a
umazilayela	u m a z i l a j E l a
umazilayele	u m a z i l a j E l E
umazilayi	u m a z i l a j i
umazise	u m a z i s E
umbala	u m b a l a
umberego	u m b E r E g O
umbhede	u m b E d E
umbiko	u m b i k O
umbuso	u m b u s O
umcithi	u m |_b i t_h i
umdlali	u m K_b a l i
umdoko	u m d O k O
umdzidlha	u m dz i K_b a
ume	u m E
umfazi	u m f a z i
umfundi	u m f u n d i
umfundisi	u m f u n d i s i
umgodi	u m g O d i
umgodla	u m g O K_b a
umgodlana	u m g O K_b a n a
umgwengweni	u m g w E N g w E n i
umhlanga	u m K a N g a
umhlo	u m K O
umkami	u m k a m i
umkayo	u m k a j O
umkgheledzwana	u m kx E l E dz w a n a
umlayezo	u m l a j E z O
umlilo	u m l i l O
ummongo	u m m O N g O
ummongondaba	u m m O N g O n d a b_< a
ummoya	u m m O j a
umnakwabo	u m n a k w a b_< O
umnguni	u m N g u n i
umnqopho	u m n !_b O p_h O
umntazana	u m n t_> a z a n a
umntazanyana	u m n t_> a z a J a n a
umntwana	u m n t_> w a n a
umntwanakhe	u m n t_> w a n a k_h E
umntwanam	u m n t_> w a n a m
umntwanami	u m n t_> w a n a m i
umnya	u m J a
umnyaka	u m J a k a
umnyango	u m J a N g O
umong	u m O N g
umoya	u m O j a
ump	u m p_h
umph	u m p_h
umpha	u m p_h a
umphakathi	u m p_h a k a t_h i
umphako	u m p_h a k O
umphathi	u m p_h a t_h i
umphefumulo	u m p_h E f u m u l O
umporofidi	u m p_> O r O f i d i
umqaka	u m !_b a k a
umqas	u m !_b a s
umqasa	u m !_b a s a
umqasana	u m !_b a s a n a
umqithi	u m !_b i t_h i
umr	u m r
umraro	u m r a r O
umratha	u m r a t_h a
umrharib	u m x a r i b_<
umrharibabo	u m x a r i b_< a b_< O
umrharibakhe	u m x a r i b_< a k_h E
umrheledzwana	u m x E l E dz w a n a
umsana	u m s a n a
umsebe	u m s E b_< E
umseben	u m s E b_< E n
umsebenzi	u m s E b_< E n z i
umsipha	u m s i p_h a
umsiphe	u m s i p_h E
umsongelwa	u m s O N g E l w a
umthatha	u m t_h a t_h a
umthetho	u m t_h E t_h O
umthwalo	u m t_h w a l O
umtlhala	u m tK_h a l a
umtwan	u m t_> w a n
umuda	u m u d a
umukghwa	u m u kx w a
umukghwana	u m u kx w a n a
umule	u m u l E
umuntu	u m u n t_> u
umuzi	u m u z i
umye	u m j E
umyeni	u m j E n i
umzakhe	u m z a k_h E
umzimba	u m z i m b a
umzukulwana	u m z u k u l w a n a
umzukulwanami	u m z u k u l w a n a m i
umzukulwanani	u m z u k u l w a n a n i
umzukulwani	u m z u k u l w a n i
umzulu	u m z u l u
umzuzwana	u m z u z w a n a
un	u n
unakabi	u n a k a b_< i
unakabini	u n a k a b_< i n i
unamtshwe	u n a m ts_h w E
unamtshweni	u n a m ts_h w E n i
undala	u n d a l a
une	u n E
unelemuko	u n E l E m u k O
unemisebenzi	u n E m i s E b_< E n z i
ung	u N g
unga	u N g a
ungabe	u N g a b_< E
ungahl	u N g a K
ungahlali	u N g a K a l i
ungakalindeleki	u N g a k a l i n d E l E k i
ungam	u N g a m
ungamthola	u N g a m t_h O l a
ungathi	u N g a t_h i
ungayiqe	u N g a j i !_b E
ungayiqeda	u N g a j i !_b E d a
ungci	u N |_bg i
ungena	u N g E n a
ungethwe	u N g E t_h w E
ungi	u N g i
ungiga	u N g i g a
ungigalaja	u N g i g a l a d_0Z a
ungigalaje	u N g i g a l a d_0Z E
ungise	u N g i s E
ungomunye	u N g O m u J E
ungow	u N g O w
ungqi	u N !_bg i
ungqongqotjhe	u N !_bg O N !_bg O tS_h E
unina	u n i n a
uno	u n O
unobhala	u n O b a l a
unogogwakhe	u n O g O g w a k_h E
unomzoyi	u n O m z O j i
unongqongqotjhe	u n O N !_bg O N !_bg O tS_h E
unontjhibila	u n O n tS_h i b_< i l a
unyaka	u J a k a
unyakeni	u J a k E n i
upen	u p_> E n
upende	u p_> E n d E
upha	u p_h a
uphake	u p_h a k E
uphatheke	u p_h a t_h E k E
uphathene	u p_h a t_h E n E
uphethe	u p_h E t_h E
uphethwe	u p_h E t_h w E
uq	u !_b
uqotjh	u !_b O tS_h
uqotjhe	u !_b O tS_h E
uqotjhiwe	u !_b O tS_h i w E
urerhe	u r E x E
urhoboyi	u x O b_< O j i
us	u s
usarulani	u s a r u l a n i
usebhund	u s E b u n d
usebhundu	u s E b u n d u
usemtlhalen	u s E m tK_h a l E n
usendleleni	u s E n K_b E l E n i
usewula	u s E w u l a
usi	u s i
usibize	u s i b_< i z E
usibizele	u s i b_< i z E l E
usibizile	u s i b_< i z i l E
usibu	u s i b_< u
usibungusehlok	u s i b_< u N g u s E K O k
usibungusehloko	u s i b_< u N g u s E K O k O
usibunu	u s i b_< u n u
uskhosan	u s k_h O s a n
uskhosana	u s k_h O s a n a
uso	u s O
usoliseni	u s O l i s E n i
usom	u s O m
usompera	u s O m p_> E r a
usompere	u s O m p_> E r E
usong	u s O N g
usonyosi	u s O J O s i
usosikhwama	u s O s i k_h w a m a
usuhla	u s u K a
uthabi	u t_h a b_< i
uthandaza	u t_h a n d a z a
uthatha	u t_h a t_h a
uthe	u t_h E
uthi	u t_h i
uthin	u t_h i n
uthini	u t_h i n i
uthugwana	u t_h u g w a n a
uthumbile	u t_h u m b i l E
utitjhere	u t_> i tS_h E r E
utitjherehloko	u t_> i tS_h E r E K O k O
utitjherethu	u t_> i tS_h E r E t_h u
utjho	u tS_h O
utjhugulu	u tS_h u g u l u
utjhuguluko	u tS_h u g u l u k O
utjwala	u tS_> w a l a
utlola	u tK_> O l a
utlwebhe	u tK_> w E b E
utsotsi	u ts_> O ts_> i
utunwana	u t_> u n w a n a
uvali	u v a l i
uvaliw	u v a l i w
uvaliwe	u v a l i w E
uvunguzela	u v u N g u z E l a
uwa	u w a
uwedwa	u w E d w a
uyabo	u j a b_< O
uyabona	u j a b_< O n a
uyak	u j a k
uyakghona	u j a kx O n a
uyal	u j a l
uyala	u j a l a
uyalal	u j a l a l
uyalayeli	u j a l a j E l i
uyalayelisa	u j a l a j E l i s a
uyalisa	u j a l i s a
uyangibuyis	u j a N g i b_< u j i s
uyangibuyisa	u j a N g i b_< u j i s a
uyarhapha	u j a x a p_h a
uyavu	u j a v u
uyavuma	u j a v u m a
uyaya	u j a j a
uyayazi	u j a j a z i
uyazitjela	u j a z i tS_> E l a
uye	u j E
uyilalel	u j i l a l E l
uyilalelwa	u j i l a l E l w a
uyilayelwa	u j i l a j E l w a
uyindoda	u j i n d O d a
uyipongwana	u j i p_> O N g w a n a
uyokubona	u j O k u b_< O n a
uz	u z
uza	u z a
uzafika	u z a f i k a
uzak	u z a k
uzaku	u z a k u
uzakufika	u z a k u f i k a
uzakukhamba	u z a k u k_h a m b a
uzakulinga	u z a k u l i N g a
uzakuphungwa	u z a k u p_h u N g w a
uzakurarululwa	u z a k u r a r u l u l w a
uzakuthi	u z a k u t_h i
uzakwazi	u z a k w a z i
uzawurarululelwa	u z a w u r a r u l u l E l w a
uzazi	u z a z i
uzazilila	u z a z i l i l a
uzibetha	u z i b_< E t_h a
uzo	u z O
uzokl	u z O k l
uzokufuna	u z O k u f u n a
uzokuhlakani	u z O k u K a k a n i
uzokuhlala	u z O k u K a l a
uzokuhlalaphi	u z O k u K a l a p_h i
uzokukghona	u z O k u kx O n a
uzokulinga	u z O k u l i N g a
uzokurareka	u z O k u r a r E k a
uzokuthatha	u z O k u t_h a t_h a
uzolinga	u z O l i N g a
uzondani	u z O n d a n i
uzongithatha	u z O N g i t_h a t_h a
uzosinghwara	u z O s i N w a r a
uzoyivuma	u z O j i v u m a
v	v
vaalbank	v a a l b_< a N k
van	v a n
vane	v a n E
varelagte	v a r E l a g t_> E
vasfontein	v a s f O n t_> E i n
vele	v E l E
verina	v E r i n a
veza	v E z a
vista	v i s t_> a
vlaaglagte	v l a a g l a g t_> E
vo	v O
voelkrans	v O E l k r a n s
vol	v O l
volum	v O l u m
volume	v O l u m E
vowudi	v O w u d i
vu	v u
w	w
wa	w a
waba	w a b_< a
wababo	w a b_< a b_< O
wabantu	w a b_< a n t_> u
wabaphunyurha	w a b_< a p_h u J u x a
wabaqotha	w a b_< a !_b O t_h a
wabaqotjha	w a b_< a !_b O tS_h a
wabavowudi	w a b_< a v O w u d i
wabe	w a b_< E
wabeseka	w a b_< E s E k a
wabesele	w a b_< E s E l E
wabo	w a b_< O
wabona	w a b_< O n a
wabuyela	w a b_< u j E l a
wadla	w a K_b a
wadosa	w a d O s a
wafakela	w a f a k E l a
wahlo	w a K O
wahlomi	w a K O m i
wahlomilek	w a K O m i l E k
wahlomileko	w a K O m i l E k O
wahlonile	w a K O n i l E
wajabula	w a d_0Z a b_< u l a
wak	w a k
waka	w a k a
wakhamba	w a k_h a m b a
wakhambela	w a k_h a m b E l a
wakhe	w a k_h E
wakho	w a k_h O
wakhona	w a k_h O n a
wakobona	w a k O b_< O n a
wakwakhe	w a k w a k_h E
wakwamdlul	w a k w a m K_b u l
wakwamdluli	w a k w a m K_b u l i
wakwamkhwebani	w a k w a m k_h w E b_< a n i
walesigaba	w a l E s i g a b_< a
walesisigaba	w a l E s i s i g a b_< a
walesisitiga	w a l E s i s i t_> i g a
walithola	w a l i t_h O l a
walu	w a l u
walun	w a l u n
walunguz	w a l u N g u z
walunguza	w a l u N g u z a
wam	w a m
wamabizo	w a m a b_< i z O
wamaguduva	w a m a g u d u v a
wamatjhumi	w a m a tS_h u m i
wamelo	w a m E l O
wamhlom	w a m K O m
wami	w a m i
wan	w a n
wange	w a N g E
wangekha	w a N g E k_h a
wangekhay	w a N g E k_h a j
wangekhaya	w a N g E k_h a j a
wangena	w a N g E n a
wangibawa	w a N g i b_< a w a
wangibiza	w a N g i b_< i z a
wanikela	w a n i k E l a
wapha	w a p_h a
waphunyurha	w a p_h u J u x a
waqeda	w a !_b E d a
warha	w a x a
warmelo	w a r m E l O
warurela	w a r u r E l a
was	w a s
wasebusika	w a s E b_< u s i k a
waterval	w a t_> E r v a l
wathatha	w a t_h a t_h a
wathe	w a t_h E
wathi	w a t_h i
wathini	w a t_h i n i
watjhiya	w a tS_h i j a
watjho	w a tS_h O
watjhumi	w a tS_h u m i
watlho	w a tK_h O
watlhorhoroja	w a tK_h O x O r O a
wavele	w a v E l E
wavuka	w a v u k a
wawungeze	w a w u N g E z E
wayibeka	w a j i b_< E k a
wayo	w a j O
wayofuna	w a j O f u n a
wayokufuna	w a j O k u f u n a
waz	w a z
we	w E
webubulo	w E b_< u b_< u l O
webusika	w E b_< u s i k a
weemfunda	w E m f u n d a
weendaba	w E n d a b_< a
weendawo	w E n d a w O
weenketo	w E N k E t_> O
weenkomo	w E N k_> O m O
weenkukhu	w E N k_> u k_h u
weenkulungwana	w E N k_> u l u N g w a n a
weflarha	w E f l a x a
weflo	w E f l O
weflora	w E f l O r a
wehlabathi	w E K a b_< a t_h i
wekha	w E k_h a
wekhabe	w E k_h a b_< E
wekhabinethe	w E k_h a b_< i n E t_h E
wekhambi	w E k_h a m b i
wekhethu	w E k_h E t_h u
wekulungwana	w E k_> u l u N g w a n a
wekulungwane	w E k_> u l u N g w a n E
welizwe	w E l i z w E
welori	w E l O r i
weltevrede	w E l t_> E v r E d E
welverdiend	w E l v E r d i E n d
wema	w E m a
wemabu	w E m a b_< u
wemakhaya	w E m a k_h a j a
wemav	w E m a v
wemavuk	w E m a v u k
wemavuka	w E m a v u k a
wemavukabes	w E m a v u k a b_< E s
wemavukabesala	w E m a v u k a b_< E s a l a
wemavukabu	w E m a v u k a b_< u
wemavus	w E m a v u s
wemavusa	w E m a v u s a
wemavusabesala	w E m a v u s a b_< E s a l a
wemba	w E m b a
wembaj	w E m b a d_0Z
wembaji	w E m b a d_0Z i
weminya	w E m i J a
weminyaka	w E m i J a k a
wemisebenzi	w E m i s E b_< E n z i
wen	w E n
wena	w E n a
wenarha	w E n a x a
wendaba	w E n d a b_< a
wendawo	w E n d a w O
wengu	w E N g u
wengub	w E N g u b_<
wengubo	w E N g u b_< O
wento	w E n t_> O
wenza	w E n z a
wenzelele	w E n z E l E l E
wenziwa	w E n z i w a
weqela	w E !_b E l a
werhawuda	w E x a w u d a
wes	w E s
wesaw	w E s a w
wesayensi	w E s a j E n s i
wesewu	w E s E w u
wesewul	w E s E w u l
wesewula	w E s E w u l a
wesgi	w E s g i
wesibili	w E s i b_< i l i
wesichotjeni	w E s i |_bh O tS_> E n i
wesifiso	w E s i f i s O
wesiqhotjeni	w E s i !_bh O tS_> E n i
wesithathu	w E s i t_h a t_h u
wesitjho	w E s i tS_h O
wesitjhotjheni	w E s i tS_h O tS_h E n i
wesondo	w E s O n d O
wesumi	w E s u m i
weswigiri	w E s w i g i r i
wetjhumi	w E tS_h u m i
wetlasi	w E tK_> a s i
wetswayi	w E ts_> w a j i
wez	w E z
wezamaphilo	w E z a m a p_h i l O
weze	w E z E
wezeemali	w E z E m a l i
wezefundo	w E z E f u n d O
wezemidlalo	w E z E m i K_b a l O
wezemisebenzi	w E z E m i s E b_< E n z i
wezerhwe	w E z E x w E
weziko	w E z i k O
wezo	w E z O
wezobuciko	w E z O b_< u |_b i k O
wezobul	w E z O b_< u l
wezokuhlakanipha	w E z O k u K a k a n i p_h a
wezokuhlalisa	w E z O k u K a l i s a
wezokuhlinzekelwa	w E z O k u K i n z E k E l w a
wezokuki	w E z O k u k i
wezokulima	w E z O k u l i m a
wezokunghonghoyila	w E z O k u N O N O j i l a
wezokuphepha	w E z O k u p_h E p_h a
wezokurhwebelana	w E z O k u x w E b_< E l a n a
wezokus	w E z O k u s
wezokusebenza	w E z O k u s E b_< E n z a
wezokusebenzi	w E z O k u s E b_< E n z i
wezokusebenzisa	w E z O k u s E b_< E n z i s a
wezokuthukiza	w E z O k u t_h u k i z a
wezokuthutha	w E z O k u t_h u t_h a
wezokuthuthukisa	w E z O k u t_h u t_h u k i s a
wezokuthuthukiswa	w E z O k u t_h u t_h u k i s w a
wezokuvikela	w E z O k u v i k E l a
wezokwenjis	w E z O k w E n d_0Z i s
wezokwenjiwa	w E z O k w E n d_0Z i w a
wezokwenza	w E z O k w E n z a
wezokwenzeka	w E z O k w E n z E k a
wezwa	w E z w a
william	w i l l i a m
witban	w i t_h b_< a n
witbank	w i t_h b_< a N k
wo	w O
wobuciko	w O b_< u |_b i k O
wobukrest	w O b_< u k r E s t_h
wobukrestu	w O b_< u k r E s t_> u
wobukulungwana	w O b_< u k u l u N g w a n a
wobunane	w O b_< u n a n E
wobundebele	w O b_< u n d E b_< E l E
wobusi	w O b_< u s i
woke	w O k E
wokobana	w O k O b_< a n a
woku	w O k u
wokudlulisa	w O k u K_b u l i s a
wokufundisa	w O k u f u n d i s a
wokuhlekelwa	w O k u K E k E l w a
wokuhli	w O k u K i
wokuhlinzekelwa	w O k u K i n z E k E l w a
wokulahlekelwa	w O k u l a K E k E l w a
wokumga	w O k u m g a
wokungam	w O k u N g a m
wokuphela	w O k u p_h E l a
wokusebenza	w O k u s E b_< E n z a
wokusebenze	w O k u s E b_< E n z E
wokusithela	w O k u s i t_h E l a
wokuthoma	w O k u t_h O m a
wokuthutha	w O k u t_h u t_h a
wokuzi	w O k u z i
wokuzisebenza	w O k u z i s E b_< E n z a
wombuso	w O m b u s O
womhl	w O m K
womndeni	w O m n d E n i
womtjhado	w O m tS_h a d O
womtloli	w O m tK_> O l i
wona	w O n a
wonderfontein	w O n d E r f O n t_> E i n
wonke	w O N k E
wu	w u
y	j
ya	j a
yaba	j a b_< a
yabaleka	j a b_< a l E k a
yabalekela	j a b_< a l E k E l a
yabaseroma	j a b_< a s E r O m a
yaberoma	j a b_< E r O m a
yabha	j a b a
yabhal	j a b a l
yabhala	j a b a l a
yabhale	j a b a l E
yabo	j a b_< O
yabuye	j a b_< u j E
yabuyela	j a b_< u j E l a
yacimeza	j a |_b i m E z a
yadlula	j a K_b u l a
yafe	j a f E
yafese	j a f E s E
yafika	j a f i k a
yafike	j a f i k E
yahlala	j a K a l a
yajama	j a d_0Z a m a
yakasinyikhaba	j a k a s i J i k_h a b_< a
yakhe	j a k_h E
yakho	j a k_h O
yakhona	j a k_h O n a
yakwa	j a k w a
yakwabongwe	j a k w a b_< O N g w E
yakwakhe	j a k w a k_h E
yakwakho	j a k w a k_h O
yakwamgidi	j a k w a m g i d i
yakwami	j a k w a m i
yamajinja	j a m a d_0Z i n d_0Z a
yamapholisa	j a m a p_h O l i s a
yamaphoyi	j a m a p_h O j i
yamaphrovinsi	j a m a p_h r O v i n s i
yamatjhumi	j a m a tS_h u m i
yami	j a m i
yamqala	j a m !_b a l a
yanamhlanje	j a n a m K a n d_0Z E
yanamhlanjesi	j a n a m K a n d_0Z E s i
yang	j a N g
yanga	j a N g a
yangakwamgidi	j a N g a k w a m g i d i
yangasesiyabus	j a N g a s E s i j a b_< u s
yangebhundu	j a N g E b u n d u
yangen	j a N g E n
yanqo	j a n !_b O
yaphe	j a p_h E
yaphela	j a p_h E l a
yaqomdana	j a !_b O m d a n a
yaqondama	j a !_b O n d a m a
yase	j a s E
yasukela	j a s u k E l a
yatha	j a t_h a
yathi	j a t_h i
yatlhoga	j a tK_h O g a
yavula	j a v u l a
yayizele	j a j i z E l E
yazo	j a z O
ye	j E
yebhundu	j E b u n d u
yeenhlangano	j E n K a N g a n O
yeenkomo	j E N k_> O m O
yefukwana	j E f u k w a n a
yefundo	j E f u n d O
yehlangano	j E K a N g a n O
yehlobo	j E K O b_< O
yejarada	j E d_0Z a r a d a
yejare	j E d_0Z a r E
yejarida	j E d_0Z a r i d a
yeke	j E k E
yekhopha	j E k_h O p_h a
yekopha	j E k O p_h a
yekuseni	j E k_> u s E n i
yekwarha	j E k w a x a
yelezili	j E l E z i l i
yelori	j E l O r i
yelwe	j E l w E
yem	j E m
yemagomedzana	j E m a g O m E dz a n a
yemaphodlha	j E m a p_h O K_b a
yeminyaka	j E m i J a k a
yemirho	j E m i x O
yemirorho	j E m i r O x O
yemmabatho	j E m m a b_< a t_h O
yen	j E n
yena	j E n a
yendoda	j E n d O d a
yendwana	j E n d w a n a
yeng	j E N g
yenganyelwe	j E N g a J E l w E
yenzele	j E n z E l E
yepitali	j E p_> i t_> a l i
yepitori	j E p_> i t_> O r i
yesewula	j E s E w u l a
yesi	j E s i
yesibili	j E s i b_< i l i
yesihloko	j E s i K O k O
yesinye	j E s i J E
yethu	j E t_h u
yeu	j E u
yeyunivesithi	j E j u n i v E s i t_h i
yezokuthuthukiswa	j E z O k u t_h u t_h u k i s w a
yi	j i
yicatjhaza	j i |_b a tS_h a z a
yifu	j i f u
yifuyo	j i f u j O
yihlangano	j i K a N g a n O
yik	j i k
yika	j i k a
yikapho	j i k a p_h O
yikhul	j i k_h u l
yikhulu	j i k_h u l u
yikoloyana	j i k O l O j a n a
yikomba	j i k O m b a
yikulungwana	j i k_> u l u N g w a n a
yilanga	j i l a N g a
yilize	j i l i z E
yin	j i n
yindlondlo	j i n K_b O n K_b O
yindrina	j i n d r i n a
yinga	j i N g a
yingakho	j i N g a k_h O
yini	j i n i
yino	j i n O
yinto	j i n t_> O
yintonyani	j i n t_> O J a n i
yinye	j i J E
yipito	j i p_> i t_> O
yipitori	j i p_> i t_> O r i
yipongwana	j i p_> O N g w a n a
yiqanda	j i !_b a n d a
yiqatjhaza	j i !_b a tS_h a z a
yiqatjhazi	j i !_b a tS_h a z i
yiqhatjhaza	j i !_bh a tS_h a z a
yiqhatjhazi	j i !_bh a tS_h a z i
yis	j i s
yisikhala	j i s i k_h a l a
yisikhombisa	j i s i k_h O m b i s a
yisindebe	j i s i n d E b_< E
yisindebele	j i s i n d E b_< E l E
yisithandathu	j i s i t_h a n d a t_h u
yisndebe	j i s n d E b_< E
yithala	j i t_h a l a
yithan	j i t_h a n
yithoba	j i t_h O b_< a
yitjhumi	j i tS_h u m i
yize	j i z E
yodwa	j O d w a
yodwan	j O d w a n
yodwana	j O d w a n a
yok	j O k
yoke	j O k E
yoku	j O k u
yokubhaqa	j O k u b a !_b a
yokufihla	j O k u f i K a
yokugwa	j O k u g w a
yokuhlambela	j O k u K a m b E l a
yokuhlinz	j O k u K i n z
yokuhlinzekela	j O k u K i n z E k E l a
yokukghwathana	j O k u kx w a t_h a n a
yokutholaka	j O k u t_h O l a k a
yokutholakala	j O k u t_h O l a k a l a
yokuthoma	j O k u t_h O m a
yomphakathi	j O m p_h a k a t_h i
yomraro	j O m r a r O
yomuntu	j O m u n t_> u
yona	j O n a
yonke	j O N k E
yosale	j O s a l E
yotjani	j O tS_> a n i
yu	j u
z	z
za	z a
zababeregi	z a b_< a b_< E r E g i
zabantu	z a b_< a n t_> u
zabo	z a b_< O
zafika	z a f i k a
zafumana	z a f u m a n a
zafunyana	z a f u J a n a
zakha	z a k_h a
zakhamba	z a k_h a m b a
zakhe	z a k_h E
zakilendawo	z a k i l E n d a w O
zako	z a k O
zakosinodolo	z a k O s i n O d O l O
zakoso	z a k O s O
zakososinodolo	z a k O s O s i n O d O l O
zakososinondola	z a k O s O s i n O n d O l a
zakososo	z a k O s O s O
zakwantuli	z a k w a n t_> u l i
zakwethu	z a k w E t_h u
zal	z a l
zala	z a l a
zale	z a l E
zalendawo	z a l E n d a w O
zaleyo	z a l E j O
zam	z a m
zama	z a m a
zamaberegi	z a m a b_< E r E g i
zamanzi	z a m a n z i
zamazwe	z a m a z w E
zami	z a m i
zangapha	z a N g a p_h a
zangaphakathi	z a N g a p_h a k a t_h i
zangaphandle	z a N g a p_h a n K_b E
zathi	z a t_h i
zay	z a j
zayokubhaqa	z a j O k u b a !_b a
zayokubhuqa	z a j O k u b u !_b a
zazibambisana	z a z i b_< a m b i s a n a
ze	z E
zebhoduluko	z E b O d u l u k O
zebhrugu	z E b r u g u
zehlabathi	z E K a b_< a t_h i
zenji	z E n d_0Z i
zenjiwe	z E n d_0Z i w E
zenu	z E n u
zepitoli	z E p_> i t_> O l i
zepoloti	z E p_> O l O t_> i
zepolotiki	z E p_> O l O t_> i k i
zesi	z E s i
zesikolo	z E s i k O l O
zeth	z E t_h
zethu	z E t_h u
zetjiwe	z E tS_> i w E
zezwa	z E z w a
zi	z i
zibunane	z i b_< u n a n E
zicabanga	z i |_b a b_< a N g a
zidla	z i K_b a
zigadane	z i g a d a n E
zigadene	z i g a d E n E
zigijimisa	z i g i d_0Z i m i s a
zigijimisana	z i g i d_0Z i m i s a n a
zigu	z i g u
ziguguruza	z i g u g u r u z a
ziguruguruza	z i g u r u g u r u z a
ziguruza	z i g u r u z a
zihlanu	z i K a n u
ziimbuzi	z i m b u z i
zik	z i k
zikabamkh	z i k a b_< a m k_h
zikabamkhulu	z i k a b_< a m k_h u l u
zikamgobha	z i k a m g O b a
zikamkhulu	z i k a m k_h u l u
zikamzoba	z i k a m z O b_< a
zikazomba	z i k a z O m b a
zikhamba	z i k_h a m b a
zikhambelane	z i k_h a m b E l a n E
zikhomba	z i k_h O m b a
zikhona	z i k_h O n a
zilala	z i l a l a
zilayitjhwe	z i l a j i tS_h w E
zile	z i l E
zilikhomba	z i l i k_h O m b a
zilindele	z i l i n d E l E
zilinga	z i l i N g a
zilitjhumi	z i l i tS_h u m i
zimash	z i m a s
zimathjumi	z i m a t_h d_0Z u m i
zimatjhumi	z i m a tS_h u m i
zimbili	z i m b i l i
zin	z i n
zine	z i n E
zinga	z i N g a
zingakalali	z i N g a k a l a l i
zingamalanga	z i N g a m a l a N g a
zingasenza	z i N g a s E n z a
zinon	z i n O n
zinone	z i n O n E
zinonile	z i n O n i l E
zinothile	z i n O t_h i l E
zintathu	z i n t_> a t_h u
ziphendulwa	z i p_h E n d u l w a
ziqabanga	z i !_b a b_< a N g a
zirhay	z i x a j
zirhaywa	z i x a j w a
zirhwaywa	z i x w a j w a
zisale	z i s a l E
zisayokududa	z i s a j O k u d u d a
zisidle	z i s i K_b E
zisithandathu	z i s i t_h a n d a t_h u
zithi	z i t_h i
zitjhayi	z i tS_h a j i
zitjhayiwe	z i tS_h a j i w E
zitjho	z i tS_h O
zitshayiwe	z i ts_h a j i w E
ziya	z i j a
ziyakhomba	z i j a k_h O m b a
ziyazi	z i j a z i
ziyifetjheni	z i j i f E tS_h E n i
ziyisumi	z i j i s u m i
ziyo	z i j O
ziyokududa	z i j O k u d u d a
zodwa	z O d w a
zoke	z O k E
zokosos	z O k O s O s
zokubhalelwa	z O k u b a l E l w a
zokutjhayela	z O k u tS_h a j E l a
zomgade	z O m g a d E
